,replacement,config,ipc,instructions,cycles,total_access,total_hit,total_miss,load_access,load_hit,load_miss,rfo_access,rfo_hit,rfo_miss,prefetch_access,prefetch_hit,prefetch_miss,writeback_access,writeback_hit,writeback_miss
0,ship++_leaders_128,config1,0.405846,100000000,246398956,1162158,351703,810455,632028,148358,483670,264148,76650,187498,0,0,0,265982,126695,139287
1,ship++_leaders_128,config1,0.72363,100000001,138192132,32512,7705,24807,21583,407,21176,3395,1,3394,0,0,0,7534,7297,237
2,ship++_leaders_128,config1,0.55932,100000001,178788628,5752304,1507985,4244319,806178,44,806134,2473059,409306,2063753,0,0,0,2473067,1098635,1374432
3,ship++_leaders_128,config1,0.40945,100000000,244230268,81693,61811,19882,53416,39658,13758,10648,4526,6122,0,0,0,17629,17627,2
4,ship++_leaders_128,config1,0.347185,100000003,288030693,4687839,803964,3883875,3310966,701947,2609019,20,0,20,0,0,0,1376853,102017,1274836
5,ship++_leaders_128,config1,1.13938,100000003,87767319,789890,121146,668744,401402,95255,306147,194181,905,193276,0,0,0,194307,24986,169321
6,ship++_leaders_128,config1,0.58819,100000000,170013166,5455664,1465137,3990527,763531,118,763413,2345910,454890,1891020,0,0,0,2346223,1010129,1336094
7,ship++_leaders_128,config1,0.285988,100000000,349664609,6993476,3792243,3201233,4167424,1810778,2356646,751795,292708,459087,0,0,0,2074257,1688757,385500
8,ship++_leaders_128,config1,0.904282,100000002,110584974,1399115,1011059,388056,1148258,766530,381728,122689,117083,5606,0,0,0,128168,127446,722
9,ship++_leaders_128,config1,0.76019,100000002,131546143,1449318,981176,468142,1202517,751663,450854,114009,102788,11221,0,0,0,132792,126725,6067
10,ship++_leaders_128,config1,0.0922202,100000002,1084361350,12167949,5950047,6217902,10389065,4729290,5659775,150300,93784,56516,0,0,0,1628584,1126973,501611
11,ship++_leaders_128,config1,1.0826,100000002,92369962,613107,286930,326177,304677,113225,191452,151946,75677,76269,0,0,0,156484,98028,58456
12,ship++_leaders_128,config1,0.235368,100000000,424866140,3244366,1297890,1946476,1932987,505826,1427161,328355,99884,228471,0,0,0,983024,692180,290844
13,ship++_leaders_128,config1,0.463606,100000000,215700342,4478842,1119439,3359403,2621533,714074,1907459,760185,100319,659866,0,0,0,1097124,305046,792078
14,ship++_leaders_128,config1,0.369084,100000001,270941018,4564556,1027001,3537555,3073734,650458,2423276,126461,108451,18010,0,0,0,1364361,268092,1096269
15,ship++_leaders_128,config1,0.444964,100000001,224737369,4917103,204982,4712121,3390381,128895,3261486,24,24,0,0,0,0,1526698,76063,1450635
16,ship++_leaders_128,config1,0.346994,100000003,288189328,4047234,254759,3792475,3006773,156864,2849909,24,18,6,0,0,0,1040437,97877,942560
17,ship++_leaders_128,config1,0.369595,100000001,270566734,2613322,2314820,298502,2495348,2216043,279305,37609,22852,14757,0,0,0,80365,75925,4440
18,ship++_leaders_128,config1,0.494543,100000000,202206681,373288,160749,212539,144396,65812,78584,71290,13083,58207,0,0,0,157602,81854,75748
19,ship++_leaders_128,config1,0.397478,100000001,251586093,2500691,1058870,1441821,2301166,860174,1440992,0,0,0,0,0,0,199525,198696,829
20,ship++_leaders_128,config1,0.455788,100000003,219400195,1769067,1241148,527919,1739412,1225892,513520,12908,2633,10275,0,0,0,16747,12623,4124
21,ship++_leaders_128,config1,0.542028,100000003,184492156,6027284,1579638,4447646,843450,158,843292,2591814,430830,2160984,0,0,0,2592020,1148650,1443370
22,ship++_leaders_128,config1,0.429641,100000003,232752642,1058894,127317,931577,632847,49539,583308,201034,795,200239,0,0,0,225013,76983,148030
23,ship++_leaders_128,config1,0.394423,100000000,253534984,411671,389982,21689,296216,280317,15899,32929,27679,5250,0,0,0,82526,81986,540
24,ship++_leaders_128,config1,0.733298,100000003,136370224,21200174,21146025,54149,194764,150662,44102,10471722,10461785,9937,0,0,0,10533688,10533578,110
25,ship++_leaders_128,config1,0.495169,100000000,201951243,3679357,1365122,2314235,2465981,861960,1604021,467651,175904,291747,0,0,0,745725,327258,418467
26,ship++_leaders_128,config1,0.828767,100000000,120661104,1432064,1208315,223749,1067513,933628,133885,180727,103588,77139,0,0,0,183824,171099,12725
27,ship++_leaders_128,config1,0.415128,100000003,240889615,1165598,359689,805909,633144,155668,477476,265372,75966,189406,0,0,0,267082,128055,139027
28,ship++_leaders_128,config1,0.381466,100000001,262146710,3801525,111537,3689988,2789401,95594,2693807,20,20,0,0,0,0,1012104,15923,996181
29,ship++_leaders_128,config1,0.428098,100000003,233591557,1105151,338834,766317,614443,166128,448315,245232,60559,184673,0,0,0,245476,112147,133329
30,ship++_leaders_128,config1,0.395895,100000003,252592408,405079,381412,23667,285435,267498,17937,34071,28786,5285,0,0,0,85573,85128,445
31,ship++_leaders_128,config1,0.4335,100000003,230680399,2675520,55227,2620293,1680645,9330,1671315,136848,7883,128965,0,0,0,858027,38014,820013
32,ship++_leaders_128,config1,0.502664,100000002,198940053,3572668,851215,2721453,2180515,514112,1666403,629126,127738,501388,0,0,0,763027,209365,553662
33,ship++_leaders_128,config1,0.23425,100000001,426895063,1984524,236851,1747673,1160616,89445,1071171,340549,30308,310241,0,0,0,483359,117098,366261
34,ship++_leaders_128,config1,0.609662,100000000,164025353,1575110,835859,739251,1332847,637145,695702,103774,77654,26120,0,0,0,138489,121060,17429
35,ship++_leaders_128,config1,0.129776,100000001,770557966,6966718,2813237,4153481,2413979,533721,1880258,1812772,761093,1051679,0,0,0,2739967,1518423,1221544
36,ship++_leaders_128,config1,0.747037,100000003,133862247,1134857,1002719,132138,519854,460880,58974,292430,224183,68247,0,0,0,322573,317656,4917
37,ship++_leaders_128,config1,0.115406,100000001,866506865,11193194,5109348,6083846,8987753,3653507,5334246,195618,123912,71706,0,0,0,2009823,1331929,677894
38,ship++_leaders_128,config1,1.02772,100000001,97302413,381989,16797,365192,315489,7047,308442,3447,1,3446,0,0,0,63053,9749,53304
39,ship++_leaders_128,config1,0.282858,100000003,353533762,7006994,3654740,3352254,4052500,1707790,2344710,856733,340945,515788,0,0,0,2097761,1606005,491756
40,ship++_leaders_128,config1,1.46983,100000003,68035048,1133161,1047369,85792,790337,734930,55407,47630,19031,28599,0,0,0,295194,293408,1786
41,ship++_leaders_128,config1,0.44003,100000003,227257279,2838711,68040,2770671,1956031,13209,1942822,140009,0,140009,0,0,0,742671,54831,687840
42,ship++_leaders_128,config1,0.316483,100000000,315972687,2825480,2582816,242664,2094626,1859745,234881,16394,16028,366,0,0,0,714460,707043,7417
43,ship++_leaders_128,config1,0.0842854,100000000,1186445290,14619503,7791255,6828248,14276896,7551160,6725736,25872,16589,9283,0,0,0,316735,223506,93229
44,ship++_leaders_128,config1,0.598496,100000000,167085539,1490750,467400,1023350,835381,194489,640892,219225,34054,185171,0,0,0,436144,238857,197287
45,ship++_leaders_128,config1,0.322946,100000002,309649067,5290143,2754029,2536114,3127297,1381370,1745927,652045,255029,397016,0,0,0,1510801,1117630,393171
46,ship++_leaders_128,config1,2.07426,100000001,48209981,1896,9,1887,1706,0,1706,181,0,181,0,0,0,9,9,0
47,ship++_leaders_128,config1,0.553263,100000000,180745723,119554,22687,96867,80540,2928,77612,1075,170,905,0,0,0,37939,19589,18350
48,ship++_leaders_128,config1,0.814901,100000002,122714255,991023,710043,280980,696691,506463,190228,102176,40550,61626,0,0,0,192156,163030,29126
49,ship++_leaders_128,config1,1.51718,100000003,65911685,827374,661829,165545,730855,565941,164914,414,392,22,0,0,0,96105,95496,609
50,ship++_leaders_128,config1,0.516368,100000003,193660281,2445955,67942,2378013,1321299,1896,1319403,423300,6187,417113,0,0,0,701356,59859,641497
51,ship++_leaders_128,config2,0.460193,100000000,217300345,1164035,326996,837039,21763,3423,18340,264086,77251,186835,612079,132485,479594,266107,113837,152270
52,ship++_leaders_128,config2,0.725224,100000001,137888497,42522,7066,35456,13577,393,13184,3352,12,3340,17694,471,17223,7899,6190,1709
53,ship++_leaders_128,config2,0.644276,100000001,155213039,5795274,1462324,4332950,417310,18494,398816,2473106,377065,2096041,431736,24290,407446,2473122,1042475,1430647
54,ship++_leaders_128,config2,0.410568,100000000,243565069,157868,133926,23942,71023,61828,9195,11273,5616,5657,50719,41861,8858,24853,24621,232
55,ship++_leaders_128,config2,0.606739,100000003,164815463,5145112,262278,4882834,521243,125489,395754,17,0,17,3246551,58847,3187704,1377301,77942,1299359
56,ship++_leaders_128,config2,1.42069,100000003,70388351,831012,62938,768074,26204,11780,14424,201213,7758,193455,400922,11757,389165,202673,31643,171030
57,ship++_leaders_128,config2,0.670164,100000000,149217207,5492899,1404740,4088159,391516,16324,375192,2345767,385720,1960047,409521,21174,388347,2346095,981522,1364573
58,ship++_leaders_128,config2,0.378321,100000000,264325835,8713538,4766862,3946676,2237199,1095341,1141858,764919,275373,489546,3550948,1631288,1919660,2160472,1764860,395612
59,ship++_leaders_128,config2,1.22581,100000003,81578781,1445931,830856,615075,118916,100870,18046,121984,120535,1449,1076637,481554,595083,128394,127897,497
60,ship++_leaders_128,config2,1.03679,100000000,96451118,1574030,806367,767663,202247,168766,33481,111348,109910,1438,1127280,396602,730678,133155,131089,2066
61,ship++_leaders_128,config2,0.109598,100000002,912426951,21077750,9765767,11311983,9505019,5915500,3589519,164380,56540,107840,9645412,2332179,7313233,1762939,1461548,301391
62,ship++_leaders_128,config2,1.3563,100000002,73729873,631956,287263,344693,36929,21445,15484,152068,75871,76197,287154,91407,195747,155805,98540,57265
63,ship++_leaders_128,config2,0.255094,100000000,392012498,4309273,1411258,2898015,1523316,453389,1069927,249958,88072,161886,1529959,189578,1340381,1006040,680219,325821
64,ship++_leaders_128,config2,0.638493,100000000,156618745,4599611,1051853,3547758,466351,131306,335045,742873,95970,646903,2290021,498330,1791691,1100366,326247,774119
65,ship++_leaders_128,config2,0.609161,100000000,164160264,4812398,551938,4260460,461919,40644,421275,126472,117279,9193,2859715,128247,2731468,1364292,265768,1098524
66,ship++_leaders_128,config2,0.557529,100000003,179362827,4917133,277446,4639687,1164347,61339,1103008,24,24,0,2226064,93293,2132771,1526698,122790,1403908
67,ship++_leaders_128,config2,0.483467,100000001,206839405,4047262,231719,3815543,834801,38559,796242,24,13,11,2172001,96679,2075322,1040436,96468,943968
68,ship++_leaders_128,config2,0.37497,100000001,266688154,4665954,2416854,2249100,2183998,2042891,141107,24958,12304,12654,2376629,302948,2073681,80369,58711,21658
69,ship++_leaders_128,config2,0.499157,100000001,200337934,479224,205839,273385,108314,57542,50772,72099,9580,62519,138949,57098,81851,159862,81619,78243
70,ship++_leaders_128,config2,0.445924,100000000,224253473,13010441,10700350,2310091,5289639,4386251,903388,0,0,0,6807384,5404525,1402859,913418,909574,3844
71,ship++_leaders_128,config2,0.460972,100000003,216933040,3283322,1529937,1753385,1564298,1269157,295141,5220,2634,2586,1696956,248099,1448857,16848,10047,6801
72,ship++_leaders_128,config2,0.624707,100000003,160075081,6075009,1535447,4539562,448429,21434,426995,2591739,399337,2192402,442872,26417,416455,2591969,1088259,1503710
73,ship++_leaders_128,config2,0.682501,100000000,146519984,1088790,140222,948568,57789,8803,48986,201521,1380,200141,600986,47926,553060,228494,82113,146381
74,ship++_leaders_128,config2,0.39757,100000000,251528310,656703,613949,42754,310909,302843,8066,30806,26497,4309,212708,182979,29729,102280,101630,650
75,ship++_leaders_128,config2,0.742055,100000003,134760949,21346126,21272083,74043,165897,131106,34791,10463422,10457725,5697,183319,149941,33378,10533488,10533311,177
76,ship++_leaders_128,config2,0.710254,100000000,140794766,3757429,1208435,2548994,404930,125174,279756,463740,173986,289754,2139581,573446,1566135,749178,335829,413349
77,ship++_leaders_128,config2,0.897347,100000000,111439594,2346651,2097270,249381,882527,863291,19236,180743,106436,74307,1098526,959506,139020,184855,168037,16818
78,ship++_leaders_128,config2,0.470324,100000003,212619337,1169020,334772,834248,25398,3890,21508,265309,74808,190501,610970,140021,470949,267343,116053,151290
79,ship++_leaders_128,config2,0.520126,100000000,192261042,3801551,130172,3671379,656093,36355,619738,20,20,0,2133333,77859,2055474,1012105,15938,996167
80,ship++_leaders_128,config2,0.484504,100000003,206396744,1107956,339415,768541,23627,3990,19637,245174,61441,183733,593645,169751,423894,245510,104233,141277
81,ship++_leaders_128,config2,0.399066,100000003,250585215,635541,576616,58925,295067,285449,9618,30363,25435,4928,206831,164388,42443,103280,101344,1936
82,ship++_leaders_128,config2,0.580125,100000003,172376559,3300884,67090,3233794,970543,298,970245,136847,10185,126662,1335405,10096,1325309,858089,46511,811578
83,ship++_leaders_128,config2,0.732683,100000001,136484717,3582799,762154,2820645,298094,71108,226986,622502,116823,505679,1898798,347049,1551749,763405,227174,536231
84,ship++_leaders_128,config2,0.26267,100000001,380706470,2541078,325813,2215265,647114,53968,593146,278170,37707,240463,1132229,80818,1051411,483565,153320,330245
85,ship++_leaders_128,config2,0.886842,100000000,112759589,1795606,740942,1054664,314400,226468,87932,99914,77535,22379,1239871,308236,931635,141421,128703,12718
86,ship++_leaders_128,config2,0.138147,100000001,723867092,8751866,2692317,6059549,1887635,480925,1406710,1828634,466956,1361678,2272791,186286,2086505,2762806,1558150,1204656
87,ship++_leaders_128,config2,0.769993,100000003,129871353,1571481,1426473,145008,429785,406939,22846,294162,233797,60365,521564,466711,54853,325970,319026,6944
88,ship++_leaders_128,config2,0.121088,100000001,825847587,18753955,8246478,10507477,8469134,4408367,4060767,206405,68100,138305,7970953,2110447,5860506,2107463,1659564,447899
89,ship++_leaders_128,config2,1.29363,100000001,77301831,382570,16288,366282,27900,453,27447,3434,4,3430,288001,4692,283309,63235,11139,52096
90,ship++_leaders_128,config2,0.364632,100000003,274248827,8729788,4537501,4192287,2230280,1041844,1188436,871477,315099,556378,3453168,1505538,1947630,2174863,1675020,499843
91,ship++_leaders_128,config2,1.77802,100000000,56242407,1161490,960076,201414,133752,124719,9033,47550,13294,34256,680366,530520,149846,299822,291543,8279
92,ship++_leaders_128,config2,0.557479,100000003,179379052,3481386,61583,3419803,1002096,34,1002062,140009,0,140009,1596610,9807,1586803,742671,51742,690929
93,ship++_leaders_128,config2,0.339721,100000000,294359062,5227587,4924826,302761,2121363,1999693,121670,29853,29578,275,2267202,2096677,170525,809169,798878,10291
94,ship++_leaders_128,config2,0.12414,100000000,805540737,26954406,13284090,13670316,11716478,9896167,1820311,27356,9504,17852,14876843,3115052,11761791,333729,263367,70362
95,ship++_leaders_128,config2,0.781549,100000000,127951043,1495389,438232,1057157,89253,25287,63966,219212,28738,190474,750777,160040,590737,436147,224167,211980
96,ship++_leaders_128,config2,0.403881,100000003,247597796,6595610,3287772,3307838,1694476,770496,923980,658483,256341,402142,2682005,1095139,1586866,1560646,1165796,394850
97,ship++_leaders_128,config2,2.07905,100000001,48098913,2155,25,2130,803,0,803,129,0,129,1200,2,1198,23,23,0
98,ship++_leaders_128,config2,0.565158,100000002,176941718,134679,35094,99585,14847,4247,10600,1247,342,905,79498,9674,69824,39087,20831,18256
99,ship++_leaders_128,config2,0.916943,100000002,109058050,1373530,1069359,304171,396209,351254,44955,104383,44432,59951,675957,516362,159595,196981,157311,39670
100,ship++_leaders_128,config2,1.92652,100000000,51907134,865122,540470,324652,110526,92776,17750,416,406,10,655868,354901,300967,98312,92387,5925
101,ship++_leaders_128,config2,0.678881,100000003,147301181,2872436,68732,2803704,739034,233,738801,423298,9236,414062,1009386,2264,1007122,700718,56999,643719
102,ship++_leaders_256,config1,0.405529,100000000,246591432,1162158,347023,815135,632028,146568,485460,264148,75987,188161,0,0,0,265982,124468,141514
103,ship++_leaders_256,config1,0.723641,100000001,138189989,32512,7681,24831,21583,408,21175,3395,1,3394,0,0,0,7534,7272,262
104,ship++_leaders_256,config1,0.572674,100000001,174619382,5752320,1514317,4238003,806178,74,806104,2473066,475831,1997235,0,0,0,2473076,1038412,1434664
105,ship++_leaders_256,config1,0.40945,100000000,244230268,81693,61812,19881,53416,39658,13758,10648,4526,6122,0,0,0,17629,17628,1
106,ship++_leaders_256,config1,0.347282,100000003,287950622,4687853,807413,3880440,3310980,705163,2605817,20,0,20,0,0,0,1376853,102250,1274603
107,ship++_leaders_256,config1,1.1397,100000003,87742187,789893,118884,671009,401404,95401,306003,194181,905,193276,0,0,0,194308,22578,171730
108,ship++_leaders_256,config1,0.583309,100000000,171435810,5455668,1445006,4010662,763534,135,763399,2345912,430462,1915450,0,0,0,2346222,1014409,1331813
109,ship++_leaders_256,config1,0.284596,100000000,351375457,6993434,3673320,3320114,4167416,1760560,2406856,751792,291586,460206,0,0,0,2074226,1621174,453052
110,ship++_leaders_256,config1,0.898201,100000002,111333659,1399110,1012180,386930,1148253,766347,381906,122689,118253,4436,0,0,0,128168,127580,588
111,ship++_leaders_256,config1,0.749946,100000002,133342896,1449267,981093,468174,1202462,747271,455191,114013,104293,9720,0,0,0,132792,129529,3263
112,ship++_leaders_256,config1,0.0923871,100000002,1082402837,12167931,5945790,6222141,10389034,4740074,5648960,150311,90394,59917,0,0,0,1628586,1115322,513264
113,ship++_leaders_256,config1,1.08224,100000002,92401075,613108,286816,326292,304677,112838,191839,151946,75706,76240,0,0,0,156485,98272,58213
114,ship++_leaders_256,config1,0.235274,100000000,425036375,3244361,1277361,1967000,1932986,501490,1431496,328357,97004,231353,0,0,0,983018,678867,304151
115,ship++_leaders_256,config1,0.463794,100000000,215613057,4478621,1115654,3362967,2621528,715321,1906207,760193,99470,660723,0,0,0,1096900,300863,796037
116,ship++_leaders_256,config1,0.369164,100000001,270882332,4564554,1013185,3551369,3073734,648709,2425025,126461,108177,18284,0,0,0,1364359,256299,1108060
117,ship++_leaders_256,config1,0.446105,100000001,224162589,4917103,241420,4675683,3390381,147211,3243170,24,24,0,0,0,0,1526698,94185,1432513
118,ship++_leaders_256,config1,0.347204,100000003,288015199,4047234,257029,3790205,3006773,159955,2846818,24,20,4,0,0,0,1040437,97054,943383
119,ship++_leaders_256,config1,0.369113,100000001,270919955,2613322,2268625,344697,2495347,2168653,326694,37610,23687,13923,0,0,0,80365,76285,4080
120,ship++_leaders_256,config1,0.491596,100000000,203419123,373285,146303,226982,144395,57608,86787,71290,15368,55922,0,0,0,157600,73327,84273
121,ship++_leaders_256,config1,0.397113,100000001,251817625,2499630,1055841,1443789,2299664,856697,1442967,0,0,0,0,0,0,199966,199144,822
122,ship++_leaders_256,config1,0.453605,100000003,220456340,1769070,1052995,716075,1739415,1036558,702857,12908,2885,10023,0,0,0,16747,13552,3195
123,ship++_leaders_256,config1,0.552211,100000003,181090182,6027264,1600981,4426283,843451,175,843276,2591800,483872,2107928,0,0,0,2592013,1116934,1475079
124,ship++_leaders_256,config1,0.429595,100000003,232777332,1058894,123877,935017,632847,49656,583191,201034,772,200262,0,0,0,225013,73449,151564
125,ship++_leaders_256,config1,0.394462,100000000,253509751,411672,390272,21400,296217,280533,15684,32929,27711,5218,0,0,0,82526,82028,498
126,ship++_leaders_256,config1,0.733304,100000003,136369023,21200174,21146029,54145,194764,150667,44097,10471722,10461785,9937,0,0,0,10533688,10533577,111
127,ship++_leaders_256,config1,0.495744,100000000,201716936,3679353,1365087,2314266,2465969,864690,1601279,467662,175624,292038,0,0,0,745722,324773,420949
128,ship++_leaders_256,config1,0.828611,100000000,120683900,1432058,1207371,224687,1067507,933688,133819,180726,105180,75546,0,0,0,183825,168503,15322
129,ship++_leaders_256,config1,0.414941,100000003,240998315,1165598,357327,808271,633144,154938,478206,265372,74984,190388,0,0,0,267082,127405,139677
130,ship++_leaders_256,config1,0.381474,100000001,262141130,3801525,111615,3689910,2789401,95672,2693729,20,20,0,0,0,0,1012104,15923,996181
131,ship++_leaders_256,config1,0.428025,100000003,233631190,1105151,338848,766303,614443,166110,448333,245232,61060,184172,0,0,0,245476,111678,133798
132,ship++_leaders_256,config1,0.395915,100000003,252579493,405078,381474,23604,285436,267562,17874,34070,28767,5303,0,0,0,85572,85145,427
133,ship++_leaders_256,config1,0.433395,100000003,230736406,2675520,51387,2624133,1680645,8926,1671719,136848,6823,130025,0,0,0,858027,35638,822389
134,ship++_leaders_256,config1,0.504135,100000002,198359474,3572710,845965,2726745,2180504,511470,1669034,629151,131459,497692,0,0,0,763055,203036,560019
135,ship++_leaders_256,config1,0.233398,100000001,428452377,1984532,231866,1752666,1160609,78355,1082254,340557,28311,312246,0,0,0,483366,125200,358166
136,ship++_leaders_256,config1,0.615654,100000000,162428946,1575107,843295,731812,1332843,640853,691990,103774,79032,24742,0,0,0,138490,123410,15080
137,ship++_leaders_256,config1,0.129045,100000001,774926179,6966722,2543543,4423179,2413979,573673,1840306,1812774,686586,1126188,0,0,0,2739969,1283284,1456685
138,ship++_leaders_256,config1,0.747025,100000003,133864259,1134850,1002792,132058,519853,460591,59262,292425,223862,68563,0,0,0,322572,318339,4233
139,ship++_leaders_256,config1,0.115509,100000001,865735550,11193205,5102153,6091052,8987770,3654666,5333104,195602,125625,69977,0,0,0,2009833,1321862,687971
140,ship++_leaders_256,config1,1.02745,100000001,97328308,381989,15950,366039,315489,7008,308481,3447,1,3446,0,0,0,63053,8941,54112
141,ship++_leaders_256,config1,0.281114,100000003,355727826,7006975,3450610,3556365,4052505,1660482,2392023,856724,286280,570444,0,0,0,2097746,1503848,593898
142,ship++_leaders_256,config1,1.45673,100000003,68646750,1133161,1028279,104882,790337,728727,61610,47630,17245,30385,0,0,0,295194,282307,12887
143,ship++_leaders_256,config1,0.43987,100000003,227340099,2838711,64771,2773940,1956031,11229,1944802,140009,0,140009,0,0,0,742671,53542,689129
144,ship++_leaders_256,config1,0.316489,100000000,315966965,2825480,2582552,242928,2094626,1859719,234907,16394,16021,373,0,0,0,714460,706812,7648
145,ship++_leaders_256,config1,0.0843424,100000000,1185643402,14619505,7799105,6820400,14276902,7557833,6719069,25871,16787,9084,0,0,0,316732,224485,92247
146,ship++_leaders_256,config1,0.601041,100000000,166378034,1490752,470749,1020003,835381,195636,639745,219225,45135,174090,0,0,0,436146,229978,206168
147,ship++_leaders_256,config1,0.322358,100000002,310213754,5290155,2740305,2549850,3127299,1371530,1755769,652039,249312,402727,0,0,0,1510817,1119463,391354
148,ship++_leaders_256,config1,2.07426,100000001,48209981,1896,9,1887,1706,0,1706,181,0,181,0,0,0,9,9,0
149,ship++_leaders_256,config1,0.55323,100000000,180756818,119555,20484,99071,80540,2920,77620,1075,170,905,0,0,0,37940,17394,20546
150,ship++_leaders_256,config1,0.815209,100000002,122667920,991022,701936,289086,696690,505026,191664,102176,41234,60942,0,0,0,192156,155676,36480
151,ship++_leaders_256,config1,1.50633,100000003,66386703,827374,653168,174206,730855,557432,173423,414,391,23,0,0,0,96105,95345,760
152,ship++_leaders_256,config1,0.516409,100000003,193644858,2445955,61041,2384914,1321299,2287,1319012,423300,6647,416653,0,0,0,701356,52107,649249
153,ship++_leaders_256,config2,0.460196,100000000,217298672,1164209,333214,830995,21877,3639,18238,264086,74141,189945,612142,140551,471591,266104,114883,151221
154,ship++_leaders_256,config2,0.725226,100000001,137888096,42522,7235,35287,13577,387,13190,3352,12,3340,17694,466,17228,7899,6370,1529
155,ship++_leaders_256,config2,0.645684,100000001,154874419,5793614,1469477,4324137,416647,17846,398801,2473089,390151,2082938,430772,23295,407477,2473106,1038185,1434921
156,ship++_leaders_256,config2,0.410569,100000000,243564525,157868,133907,23961,71023,61829,9194,11273,5616,5657,50719,41846,8873,24853,24616,237
157,ship++_leaders_256,config2,0.606467,100000003,164889446,5145120,253205,4891915,521316,124812,396504,17,0,17,3246490,51861,3194629,1377297,76532,1300765
158,ship++_leaders_256,config2,1.42236,100000003,70305653,831099,64168,766931,26239,12339,13900,201209,7753,193456,400992,11523,389469,202659,32553,170106
159,ship++_leaders_256,config2,0.676136,100000000,147899200,5490717,1413458,4077259,390243,15267,374976,2345811,416617,1929194,408518,19916,388602,2346145,961658,1384487
160,ship++_leaders_256,config2,0.378831,100000000,263969841,8713943,4777919,3936024,2237004,1099999,1137005,764922,281850,483072,3551532,1637118,1914414,2160485,1758952,401533
161,ship++_leaders_256,config2,1.23604,100000003,80903477,1445923,878819,567104,118907,103396,15511,121983,120812,1171,1076638,526417,550221,128395,128194,201
162,ship++_leaders_256,config2,1.04248,100000000,95924641,1574036,833196,740840,202214,168348,33866,111346,109642,1704,1127322,423980,703342,133154,131226,1928
163,ship++_leaders_256,config2,0.109914,100000002,909800215,21078334,9627658,11450676,9505649,5932925,3572724,164413,59306,105107,9645341,2282953,7362388,1762931,1352474,410457
164,ship++_leaders_256,config2,1.35156,100000002,73988534,631960,280790,351170,36755,19186,17569,152070,75862,76208,287329,88224,199105,155806,97518,58288
165,ship++_leaders_256,config2,0.254922,100000000,392277393,4309290,1423087,2886203,1523326,447823,1075503,250119,94162,155957,1529815,192810,1337005,1006030,688292,317738
166,ship++_leaders_256,config2,0.639862,100000000,156283624,4599425,1100415,3499010,466228,134202,332026,742839,97655,645184,2289864,540487,1749377,1100494,328071,772423
167,ship++_leaders_256,config2,0.609756,100000001,164000147,4812805,543615,4269190,461897,42972,418925,126471,117280,9191,2860146,129120,2731026,1364291,254243,1110048
168,ship++_leaders_256,config2,0.55659,100000003,179665340,4917133,273858,4643275,1164659,60092,1104567,24,24,0,2225752,90739,2135013,1526698,123003,1403695
169,ship++_leaders_256,config2,0.4873,100000001,205212590,4047262,244962,3802300,835835,40055,795780,24,20,4,2170967,103315,2067652,1040436,101572,938864
170,ship++_leaders_256,config2,0.374726,100000001,266861677,4665151,2402138,2263013,2183782,2011569,172213,24954,13138,11816,2376046,317433,2058613,80369,59998,20371
171,ship++_leaders_256,config2,0.499749,100000001,200100273,479229,209238,269991,108315,59434,48881,72099,9684,62415,138953,56085,82868,159862,84035,75827
172,ship++_leaders_256,config2,0.445714,100000000,224359155,13009925,10695425,2314500,5289771,4385312,904459,0,0,0,6807099,5401059,1406040,913055,909054,4001
173,ship++_leaders_256,config2,0.458289,100000003,218202981,3283920,1501410,1782510,1566738,1150555,416183,5220,2447,2773,1695114,338723,1356391,16848,9685,7163
174,ship++_leaders_256,config2,0.625365,100000003,159906601,6073545,1548610,4524935,447804,20781,427023,2591744,411661,2180083,442036,25621,416415,2591961,1090547,1501414
175,ship++_leaders_256,config2,0.682771,100000000,146462001,1088393,135628,952765,57814,8581,49233,201518,1275,200243,600593,50119,550474,228468,75653,152815
176,ship++_leaders_256,config2,0.397557,100000000,251536018,656698,613526,43172,310902,302906,7996,30805,26527,4278,212709,182573,30136,102282,101520,762
177,ship++_leaders_256,config2,0.742082,100000003,134756017,21346126,21272733,73393,165897,131128,34769,10463422,10457724,5698,183319,150583,32736,10533488,10533298,190
178,ship++_leaders_256,config2,0.712755,100000000,140300710,3757182,1265470,2491712,404958,127441,277517,463744,173467,290277,2139290,625103,1514187,749190,339459,409731
179,ship++_leaders_256,config2,0.896698,100000000,111520258,2346548,2094824,251724,882499,862230,20269,180699,107232,73467,1098537,955286,143251,184813,170076,14737
180,ship++_leaders_256,config2,0.470284,100000003,212637672,1168942,333822,835120,25725,3873,21852,265309,72869,192440,610564,141628,468936,267344,115452,151892
181,ship++_leaders_256,config2,0.520354,100000000,192176865,3801551,129264,3672287,656220,36401,619819,20,20,0,2133206,76950,2056256,1012105,15893,996212
182,ship++_leaders_256,config2,0.484701,100000003,206312704,1107609,336130,771479,23031,3974,19057,245174,69611,175563,593894,158751,435143,245510,103794,141716
183,ship++_leaders_256,config2,0.399113,100000003,250555682,635530,577265,58265,295068,285491,9577,30364,25700,4664,206819,164446,42373,103279,101628,1651
184,ship++_leaders_256,config2,0.580242,100000003,172341871,3300884,65225,3235659,970530,471,970059,136847,10215,126632,1335418,9416,1326002,858089,45123,812966
185,ship++_leaders_256,config2,0.732716,100000001,136478576,3582936,747795,2835141,297842,71474,226368,622461,116281,506180,1899276,342400,1556876,763357,217640,545717
186,ship++_leaders_256,config2,0.26246,100000001,381010249,2540891,321168,2219723,647362,52848,594514,277955,36210,241745,1132144,77683,1054461,483430,154427,329003
187,ship++_leaders_256,config2,0.899352,100000000,111191214,1795792,760052,1035740,314367,247027,67340,99583,86581,13002,1240420,294882,945538,141422,131562,9860
188,ship++_leaders_256,config2,0.138392,100000001,722584066,8751456,2657853,6093603,1887208,485778,1401430,1828633,489339,1339294,2272804,176230,2096574,2762811,1506506,1256305
189,ship++_leaders_256,config2,0.770151,100000003,129844596,1571404,1426163,145241,429792,407090,22702,294164,234189,59975,521475,466028,55447,325973,318856,7117
190,ship++_leaders_256,config2,0.121367,100000001,823947942,18754305,8234165,10520140,8468924,4428473,4040451,206401,70994,135407,7971476,2106297,5865179,2107504,1628401,479103
191,ship++_leaders_256,config2,1.2936,100000001,77303828,382569,15343,367226,27945,567,27378,3434,3,3431,287954,4768,283186,63236,10005,53231
192,ship++_leaders_256,config2,0.363663,100000003,274979585,8730765,4514537,4216228,2230930,1029509,1201421,871510,336027,535483,3453406,1484306,1969100,2174919,1664695,510224
193,ship++_leaders_256,config2,1.78407,100000000,56051478,1161494,966782,194712,133743,126875,6868,47550,16403,31147,680376,533601,146775,299825,289903,9922
194,ship++_leaders_256,config2,0.557507,100000003,179370052,3481389,61897,3419492,1002091,22,1002069,140009,0,140009,1596618,10349,1586269,742671,51526,691145
195,ship++_leaders_256,config2,0.339691,100000000,294384905,5227620,4927571,300049,2121357,1999642,121715,29853,29585,268,2267240,2098163,169077,809170,800181,8989
196,ship++_leaders_256,config2,0.125165,100000000,798948313,26952944,13275529,13677415,11715473,9963854,1751619,27352,10100,17252,14876405,3060110,11816295,333714,241465,92249
197,ship++_leaders_256,config2,0.78148,100000000,127962392,1495363,424256,1071107,89174,25344,63830,219210,35283,183927,750833,151561,599272,436146,212068,224078
198,ship++_leaders_256,config2,0.40383,100000003,247629210,6596510,3272256,3324254,1693790,764193,929597,658492,245161,413331,2683596,1102197,1581399,1560632,1160705,399927
199,ship++_leaders_256,config2,2.07905,100000001,48098913,2155,25,2130,803,0,803,129,0,129,1200,2,1198,23,23,0
200,ship++_leaders_256,config2,0.565163,100000002,176939999,134747,34018,100729,14845,4282,10563,1238,334,904,79567,9833,69734,39097,19569,19528
201,ship++_leaders_256,config2,0.9163,100000002,109134575,1373531,1061852,311679,396212,350973,45239,104384,43145,61239,675953,512673,163280,196982,155061,41921
202,ship++_leaders_256,config2,1.88923,100000000,52931596,865119,506438,358681,110517,91519,18998,417,404,13,655873,318370,337503,98312,96145,2167
203,ship++_leaders_256,config2,0.678563,100000003,147370200,2872436,46704,2825732,739141,203,738938,423298,4999,418299,1009279,2594,1006685,700718,38908,661810
204,ship++_shctr_6,config1,0.406677,100000000,245895323,1162158,358205,803953,632028,152703,479325,264148,77317,186831,0,0,0,265982,128185,137797
205,ship++_shctr_6,config1,0.723638,100000001,138190642,32513,7872,24641,21583,407,21176,3395,1,3394,0,0,0,7535,7464,71
206,ship++_shctr_6,config1,0.558733,100000001,178976508,5752311,1465785,4286526,806178,33,806145,2473060,400777,2072283,0,0,0,2473073,1064975,1408098
207,ship++_shctr_6,config1,0.40945,100000000,244230268,81693,61811,19882,53416,39658,13758,10648,4526,6122,0,0,0,17629,17627,2
208,ship++_shctr_6,config1,0.347715,100000003,287591554,4687849,808851,3878998,3310976,703919,2607057,20,0,20,0,0,0,1376853,104932,1271921
209,ship++_shctr_6,config1,1.13966,100000003,87745716,789891,120821,669070,401403,95367,306036,194182,906,193276,0,0,0,194306,24548,169758
210,ship++_shctr_6,config1,0.589774,100000000,169556364,5455677,1491019,3964658,763532,128,763404,2345919,462568,1883351,0,0,0,2346226,1028323,1317903
211,ship++_shctr_6,config1,0.287146,100000000,348254519,6993592,3930590,3063002,4167491,1842023,2325468,751795,305963,445832,0,0,0,2074306,1782604,291702
212,ship++_shctr_6,config1,0.903521,100000002,110678171,1399112,1029770,369342,1148255,782327,365928,122689,119664,3025,0,0,0,128168,127779,389
213,ship++_shctr_6,config1,0.747886,100000002,133710175,1449242,963874,485368,1202437,728810,473627,114013,105802,8211,0,0,0,132792,129262,3530
214,ship++_shctr_6,config1,0.0923287,100000002,1083086691,12167990,5936637,6231353,10389116,4740296,5648820,150275,89869,60406,0,0,0,1628599,1106472,522127
215,ship++_shctr_6,config1,1.08311,100000002,92326600,613108,286813,326295,304677,113502,191175,151946,75547,76399,0,0,0,156485,97764,58721
216,ship++_shctr_6,config1,0.234818,100000000,425861656,3244343,1272367,1971976,1932992,496770,1436222,328349,97756,230593,0,0,0,983002,677841,305161
217,ship++_shctr_6,config1,0.464568,100000000,215253542,4478798,1157717,3321081,2621593,727156,1894437,760130,100841,659289,0,0,0,1097075,329720,767355
218,ship++_shctr_6,config1,0.36974,100000001,270460208,4564553,1033298,3531255,3073733,650216,2423517,126461,111587,14874,0,0,0,1364359,271495,1092864
219,ship++_shctr_6,config1,0.445,100000001,224719182,4917103,206782,4710321,3390381,129722,3260659,24,24,0,0,0,0,1526698,77036,1449662
220,ship++_shctr_6,config1,0.347142,100000003,288066585,4047234,257120,3790114,3006773,159339,2847434,24,18,6,0,0,0,1040437,97763,942674
221,ship++_shctr_6,config1,0.369195,100000001,270859901,2613321,2340814,272507,2495336,2243070,252266,37620,21770,15850,0,0,0,80365,75974,4391
222,ship++_shctr_6,config1,0.491898,100000000,203294191,373287,148273,225014,144396,58445,85951,71290,16905,54385,0,0,0,157601,72923,84678
223,ship++_shctr_6,config1,0.397168,100000001,251782776,2498190,1054359,1443831,2298361,855426,1442935,0,0,0,0,0,0,199829,198933,896
224,ship++_shctr_6,config1,0.457852,100000003,218411401,1769070,1326473,442597,1739415,1312302,427113,12908,2645,10263,0,0,0,16747,11526,5221
225,ship++_shctr_6,config1,0.542377,100000003,184373603,6027266,1506495,4520771,843448,160,843288,2591804,402787,2189017,0,0,0,2592014,1103548,1488466
226,ship++_shctr_6,config1,0.429797,100000003,232668035,1058894,131019,927875,632847,49418,583429,201034,793,200241,0,0,0,225013,80808,144205
227,ship++_shctr_6,config1,0.394426,100000000,253532864,411671,390106,21565,296216,280284,15932,32929,27679,5250,0,0,0,82526,82143,383
228,ship++_shctr_6,config1,0.733285,100000003,136372625,21200174,21146041,54133,194764,150672,44092,10471722,10461785,9937,0,0,0,10533688,10533584,104
229,ship++_shctr_6,config1,0.497335,100000000,201071861,3679358,1376037,2303321,2465976,867124,1598852,467663,176460,291203,0,0,0,745719,332453,413266
230,ship++_shctr_6,config1,0.82904,100000000,120621432,1432045,1206157,225888,1067511,937028,130483,180716,101595,79121,0,0,0,183818,167534,16284
231,ship++_shctr_6,config1,0.413045,100000003,242104196,1165597,351586,814011,633144,147737,485407,265372,75610,189762,0,0,0,267081,128239,138842
232,ship++_shctr_6,config1,0.381473,100000001,262141861,3801525,111697,3689828,2789401,95754,2693647,20,20,0,0,0,0,1012104,15923,996181
233,ship++_shctr_6,config1,0.426593,100000003,234415465,1105151,340438,764713,614443,159011,455432,245232,68648,176584,0,0,0,245476,112779,132697
234,ship++_shctr_6,config1,0.395918,100000003,252577687,405077,381538,23539,285435,267598,17837,34070,28819,5251,0,0,0,85572,85121,451
235,ship++_shctr_6,config1,0.433609,100000003,230622283,2675520,63279,2612241,1680645,8754,1671891,136848,10729,126119,0,0,0,858027,43796,814231
236,ship++_shctr_6,config1,0.501759,100000002,199298758,3572728,842648,2730080,2180514,508357,1672157,629154,125807,503347,0,0,0,763060,208484,554576
237,ship++_shctr_6,config1,0.234887,100000001,425736243,1984562,256957,1727605,1160784,99764,1061020,340382,32674,307708,0,0,0,483396,124519,358877
238,ship++_shctr_6,config1,0.611994,100000000,163400292,1575104,851731,723373,1332839,656606,676233,103774,75400,28374,0,0,0,138491,119725,18766
239,ship++_shctr_6,config1,0.129176,100000001,774136736,6966703,2757755,4208948,2413967,518488,1895479,1812771,715017,1097754,0,0,0,2739965,1524250,1215715
240,ship++_shctr_6,config1,0.746897,100000003,133887223,1134875,1001890,132985,519854,460898,58956,292436,223463,68973,0,0,0,322585,317529,5056
241,ship++_shctr_6,config1,0.11434,100000001,874581127,11193200,4952207,6240993,8987757,3569504,5418253,195625,118735,76890,0,0,0,2009818,1263968,745850
242,ship++_shctr_6,config1,1.02652,100000001,97416914,381989,15262,366727,315489,5728,309761,3447,1,3446,0,0,0,63053,9533,53520
243,ship++_shctr_6,config1,0.282924,100000003,353452085,7007002,3696827,3310175,4052518,1713495,2339023,856729,325712,531017,0,0,0,2097755,1657620,440135
244,ship++_shctr_6,config1,1.46096,100000003,68448162,1133161,1045355,87806,790337,732557,57780,47630,19314,28316,0,0,0,295194,293484,1710
245,ship++_shctr_6,config1,0.439855,100000003,227347387,2838711,65423,2773288,1956031,11744,1944287,140009,0,140009,0,0,0,742671,53679,688992
246,ship++_shctr_6,config1,0.316463,100000000,315992990,2825480,2582551,242929,2094626,1859636,234990,16394,16022,372,0,0,0,714460,706893,7567
247,ship++_shctr_6,config1,0.0843304,100000000,1185812303,14619479,7796491,6822988,14276874,7556965,6719909,25871,16613,9258,0,0,0,316734,222913,93821
248,ship++_shctr_6,config1,0.598723,100000000,167022121,1490749,441086,1049663,835380,195617,639763,219225,29365,189860,0,0,0,436144,216104,220040
249,ship++_shctr_6,config1,0.323496,100000002,309122996,5290136,2794576,2495560,3127292,1398390,1728902,652036,261196,390840,0,0,0,1510808,1134990,375818
250,ship++_shctr_6,config1,2.07426,100000001,48209981,1896,9,1887,1706,0,1706,181,0,181,0,0,0,9,9,0
251,ship++_shctr_6,config1,0.553272,100000000,180743000,119555,22851,96704,80540,2977,77563,1075,170,905,0,0,0,37940,19704,18236
252,ship++_shctr_6,config1,0.814714,100000002,122742406,991024,708816,282208,696690,505003,191687,102178,39948,62230,0,0,0,192156,163865,28291
253,ship++_shctr_6,config1,1.48297,100000003,67432200,827374,632679,194695,730855,536790,194065,414,393,21,0,0,0,96105,95496,609
254,ship++_shctr_6,config1,0.516236,100000003,193709666,2445955,76093,2369862,1321299,2008,1319291,423300,6190,417110,0,0,0,701356,67895,633461
255,ship++_shctr_6,config2,0.459727,100000000,217520482,1164123,328551,835572,21820,2236,19584,264086,77064,187022,612111,134186,477925,266106,115065,151041
256,ship++_shctr_6,config2,0.725208,100000001,137891538,42522,7078,35444,13577,394,13183,3352,12,3340,17694,474,17220,7899,6198,1701
257,ship++_shctr_6,config2,0.645314,100000001,154963230,5795277,1452301,4342976,417463,18677,398786,2473095,384000,2089095,431601,24135,407466,2473118,1025489,1447629
258,ship++_shctr_6,config2,0.410569,100000000,243564378,157868,133925,23943,71023,61828,9195,11273,5616,5657,50719,41858,8861,24853,24623,230
259,ship++_shctr_6,config2,0.606317,100000003,164930207,5145108,264508,4880600,521210,124312,396898,17,0,17,3246585,58427,3188158,1377296,81769,1295527
260,ship++_shctr_6,config2,1.42195,100000003,70325996,832193,68176,764017,26560,12579,13981,201393,7912,193481,401360,14909,386451,202880,32776,170104
261,ship++_shctr_6,config2,0.672805,100000000,148631547,5494450,1423827,4070623,392065,17009,375056,2345800,394179,1951621,410458,21949,388509,2346127,990690,1355437
262,ship++_shctr_6,config2,0.378427,100000000,264251565,8714442,4772187,3942255,2237772,1093352,1144420,764922,276689,488233,3551246,1627141,1924105,2160502,1775005,385497
263,ship++_shctr_6,config2,1.22566,100000003,81588756,1445927,854386,591541,118915,99524,19391,121991,120567,1424,1076627,506146,570481,128394,128149,245
264,ship++_shctr_6,config2,1.05359,100000000,94914021,1574049,840180,733869,202234,168394,33840,111345,109658,1687,1127315,430539,696776,133155,131589,1566
265,ship++_shctr_6,config2,0.109461,100000002,913569900,21078537,9693298,11385239,9505837,5895747,3610090,164389,53592,110797,9645437,2279732,7365705,1762874,1464227,298647
266,ship++_shctr_6,config2,1.35666,100000002,73710202,631967,290100,341867,37076,22417,14659,152064,75865,76199,287019,92966,194053,155808,98852,56956
267,ship++_shctr_6,config2,0.254519,100000000,392897496,4309268,1383702,2925566,1522730,446342,1076388,250368,92402,157966,1530135,186297,1343838,1006035,658661,347374
268,ship++_shctr_6,config2,0.638108,100000000,156713180,4599697,1056939,3542758,465757,129433,336324,742713,96132,646581,2290873,485247,1805626,1100354,346127,754227
269,ship++_shctr_6,config2,0.608797,100000001,164258410,4812774,564683,4248091,461870,41173,420697,126472,117199,9273,2860139,127411,2732728,1364293,278900,1085393
270,ship++_shctr_6,config2,0.555727,100000003,179944501,4917133,276907,4640226,1165128,55520,1109608,24,24,0,2225283,94182,2131101,1526698,127181,1399517
271,ship++_shctr_6,config2,0.483073,100000001,207007904,4047262,227406,3819856,834592,35662,798930,24,14,10,2172210,95610,2076600,1040436,96120,944316
272,ship++_shctr_6,config2,0.374679,100000001,266895367,4664804,2413229,2251575,2183165,2026649,156516,24955,12154,12801,2376315,311078,2065237,80369,63348,17021
273,ship++_shctr_6,config2,0.499816,100000001,200073736,479226,215483,263743,108312,60043,48269,72099,10697,61402,138955,58392,80563,159860,86351,73509
274,ship++_shctr_6,config2,0.446044,100000000,224193290,13010392,10700478,2309914,5289586,4386690,902896,0,0,0,6807389,5404048,1403341,913417,909740,3677
275,ship++_shctr_6,config2,0.462753,100000003,216098102,3282860,1550123,1732737,1562112,1350432,211680,5220,2697,2523,1698680,188589,1510091,16848,8405,8443
276,ship++_shctr_6,config2,0.621496,100000003,160902156,6073100,1565798,4507302,447908,20676,427232,2591743,390472,2201271,441479,25261,416218,2591970,1129389,1462581
277,ship++_shctr_6,config2,0.682236,100000000,146576829,1089043,142070,946973,57702,8763,48939,201523,1450,200073,601299,48455,552844,228519,83402,145117
278,ship++_shctr_6,config2,0.39753,100000000,251553632,656694,613796,42898,310900,302710,8190,30806,26542,4264,212708,182859,29849,102280,101685,595
279,ship++_shctr_6,config2,0.742158,100000003,134742110,21346125,21272499,73626,165898,131122,34776,10463422,10457724,5698,183317,150343,32974,10533488,10533310,178
280,ship++_shctr_6,config2,0.708877,100000000,141068221,3757218,1192033,2565185,404615,122226,282389,463744,173977,289767,2139677,564253,1575424,749182,331577,417605
281,ship++_shctr_6,config2,0.897021,100000000,111480156,2346532,2099165,247367,882469,863525,18944,180741,106293,74448,1098464,962224,136240,184858,167123,17735
282,ship++_shctr_6,config2,0.469848,100000003,212834617,1168822,336451,832371,25203,2603,22600,265309,75982,189327,610964,141279,469685,267346,116587,150759
283,ship++_shctr_6,config2,0.519994,100000000,192310008,3801551,128301,3673250,655867,36897,618970,20,20,0,2133559,75453,2058106,1012105,15931,996174
284,ship++_shctr_6,config2,0.484496,100000003,206399946,1107577,334644,772933,23150,3633,19517,245174,65858,179316,593744,161925,431819,245509,103228,142281
285,ship++_shctr_6,config2,0.399096,100000003,250566598,635536,579657,55879,295071,284977,10094,30363,25528,4835,206821,167542,39279,103281,101610,1671
286,ship++_shctr_6,config2,0.580286,100000003,172328889,3300884,85178,3215706,970637,247,970390,136847,15324,121523,1335311,10425,1324886,858089,59182,798907
287,ship++_shctr_6,config2,0.727433,100000001,137469744,3582758,746500,2836258,297002,61288,235714,622476,117995,504481,1899911,327517,1572394,763369,239700,523669
288,ship++_shctr_6,config2,0.263411,100000001,379634279,2541288,353407,2187881,647248,66288,580960,278171,34320,243851,1132213,83715,1048498,483656,169084,314572
289,ship++_shctr_6,config2,0.877539,100000000,113955102,1795720,725031,1070689,315557,205197,110360,99618,76905,22713,1239124,313978,925146,141421,128951,12470
290,ship++_shctr_6,config2,0.137723,100000001,726096019,8752844,2589973,6162871,1888567,475974,1412593,1828641,405780,1422861,2272824,193472,2079352,2762812,1514747,1248065
291,ship++_shctr_6,config2,0.770113,100000003,129851128,1571409,1424953,146456,429728,407123,22605,294157,233413,60744,521550,466193,55357,325974,318224,7750
292,ship++_shctr_6,config2,0.121145,100000001,825460219,18753558,8244202,10509356,8469156,4413209,4055947,206425,69069,137356,7970467,2096625,5873842,2107510,1665299,442211
293,ship++_shctr_6,config2,1.29397,100000001,77281723,382567,18343,364224,27952,435,27517,3434,3,3431,287945,4522,283423,63236,13383,49853
294,ship++_shctr_6,config2,0.366129,100000003,273127431,8729286,4600104,4129182,2229672,1051993,1177679,871501,328973,542528,3453238,1507310,1945928,2174875,1711828,463047
295,ship++_shctr_6,config2,1.80299,100000000,55463376,1161490,1022598,138892,133697,127444,6253,47550,19937,27613,680419,576917,103502,299824,298300,1524
296,ship++_shctr_6,config2,0.557498,100000003,179372842,3481389,61679,3419710,1002050,47,1002003,140009,0,140009,1596659,9770,1586889,742671,51862,690809
297,ship++_shctr_6,config2,0.339686,100000000,294389364,5227573,4924049,303524,2121356,1999607,121749,29853,29577,276,2267199,2095790,171409,809165,799075,10090
298,ship++_shctr_6,config2,0.123021,100000000,812867452,26953862,13362562,13591300,11715839,9816341,1899498,27355,10815,16540,14876946,3260356,11616590,333722,275050,58672
299,ship++_shctr_6,config2,0.781552,100000000,127950492,1495369,467553,1027816,89196,24131,65065,219211,37983,181228,750812,157115,593697,436150,248324,187826
300,ship++_shctr_6,config2,0.404388,100000003,247287515,6596114,3318103,3278011,1693620,767830,925790,658482,255006,403476,2683373,1109127,1574246,1560639,1186140,374499
301,ship++_shctr_6,config2,2.07905,100000001,48098913,2155,25,2130,803,0,803,129,0,129,1200,2,1198,23,23,0
302,ship++_shctr_6,config2,0.565149,100000002,176944603,134848,36165,98683,14918,4322,10596,1272,368,904,79522,9831,69691,39136,21644,17492
303,ship++_shctr_6,config2,0.915608,100000002,109217052,1373528,1060796,312732,396210,349781,46429,104381,40797,63584,675956,511895,164061,196981,158323,38658
304,ship++_shctr_6,config2,1.96359,100000000,50927180,865129,554135,310994,110528,92712,17816,417,406,11,655872,373036,282836,98312,87981,10331
305,ship++_shctr_6,config2,0.678674,100000003,147346064,2872436,74643,2797793,739080,101,738979,423298,7234,416064,1009340,1777,1007563,700718,65531,635187
306,ship++_shctr_9,config1,0.408331,100000000,244899264,1162158,366436,795722,632028,159900,472128,264148,77897,186251,0,0,0,265982,128639,137343
307,ship++_shctr_9,config1,0.723638,100000001,138190642,32513,7872,24641,21583,407,21176,3395,1,3394,0,0,0,7535,7464,71
308,ship++_shctr_9,config1,0.558296,100000001,179116406,5752289,1399860,4352429,806178,37,806141,2473048,385870,2087178,0,0,0,2473063,1013953,1459110
309,ship++_shctr_9,config1,0.40945,100000000,244230268,81693,61811,19882,53416,39658,13758,10648,4526,6122,0,0,0,17629,17627,2
310,ship++_shctr_9,config1,0.347241,100000003,287984611,4687855,807088,3880767,3310982,701837,2609145,20,0,20,0,0,0,1376853,105251,1271602
311,ship++_shctr_9,config1,1.13967,100000003,87744962,789892,120873,669019,401403,95369,306034,194182,906,193276,0,0,0,194307,24598,169709
312,ship++_shctr_9,config1,0.572616,100000000,174637029,5455662,1340807,4114855,763535,149,763386,2345910,349551,1996359,0,0,0,2346217,991107,1355110
313,ship++_shctr_9,config1,0.286494,100000000,349047475,6993645,3878119,3115526,4167514,1810516,2356998,751799,326951,424848,0,0,0,2074332,1740652,333680
314,ship++_shctr_9,config1,0.889139,100000002,112468312,1399110,1002051,397059,1148253,754590,393663,122689,119728,2961,0,0,0,128168,127733,435
315,ship++_shctr_9,config1,0.757574,100000002,132000219,1449310,989009,460301,1202505,756749,445756,114013,103681,10332,0,0,0,132792,128579,4213
316,ship++_shctr_9,config1,0.0924077,100000002,1082161431,12167971,5956155,6211816,10389129,4749016,5640113,150257,92435,57822,0,0,0,1628585,1114704,513881
317,ship++_shctr_9,config1,1.0829,100000002,92344445,613105,286834,326271,304677,113540,191137,151946,75537,76409,0,0,0,156482,97757,58725
318,ship++_shctr_9,config1,0.234867,100000000,425772780,3244336,1285633,1958703,1932864,503104,1429760,328476,98362,230114,0,0,0,982996,684167,298829
319,ship++_shctr_9,config1,0.464134,100000000,215454878,4478772,1155940,3322832,2621625,724519,1897106,760107,100915,659192,0,0,0,1097040,330506,766534
320,ship++_shctr_9,config1,0.369579,100000001,270577875,4564551,1033947,3530604,3073734,649926,2423808,126461,110811,15650,0,0,0,1364356,273210,1091146
321,ship++_shctr_9,config1,0.445397,100000001,224518660,4917103,214873,4702230,3390381,134707,3255674,24,24,0,0,0,0,1526698,80142,1446556
322,ship++_shctr_9,config1,0.347138,100000003,288069718,4047234,256288,3790946,3006773,158691,2848082,24,18,6,0,0,0,1040437,97579,942858
323,ship++_shctr_9,config1,0.369203,100000001,270854033,2613321,2339702,273619,2495345,2242318,253027,37611,21707,15904,0,0,0,80365,75677,4688
324,ship++_shctr_9,config1,0.490193,100000000,204001102,373289,141948,231341,144397,49640,94757,71290,18801,52489,0,0,0,157602,73507,84095
325,ship++_shctr_9,config1,0.398272,100000001,251084650,2501096,1063161,1437935,2300940,863808,1437132,0,0,0,0,0,0,200156,199353,803
326,ship++_shctr_9,config1,0.458192,100000003,218249098,1769070,1381395,387675,1739415,1367629,371786,12908,2613,10295,0,0,0,16747,11153,5594
327,ship++_shctr_9,config1,0.542347,100000003,184383911,6027232,1510838,4516394,843451,160,843291,2591787,404737,2187050,0,0,0,2591994,1105941,1486053
328,ship++_shctr_9,config1,0.429635,100000003,232755736,1058894,130119,928775,632847,48550,584297,201034,793,200241,0,0,0,225013,80776,144237
329,ship++_shctr_9,config1,0.39445,100000000,253517808,411671,390231,21440,296216,280423,15793,32929,27661,5268,0,0,0,82526,82147,379
330,ship++_shctr_9,config1,0.733239,100000003,136381252,21200174,21146044,54130,194764,150679,44085,10471722,10461785,9937,0,0,0,10533688,10533580,108
331,ship++_shctr_9,config1,0.496011,100000000,201608577,3679356,1376422,2302934,2465976,865676,1600300,467653,176677,290976,0,0,0,745727,334069,411658
332,ship++_shctr_9,config1,0.830881,100000000,120354146,1432050,1200090,231960,1067512,939534,127978,180719,100364,80355,0,0,0,183819,160192,23627
333,ship++_shctr_9,config1,0.41623,100000003,240251927,1165599,364120,801479,633144,160890,472254,265372,73897,191475,0,0,0,267083,129333,137750
334,ship++_shctr_9,config1,0.381526,100000001,262105116,3801525,112759,3688766,2789401,96816,2692585,20,20,0,0,0,0,1012104,15923,996181
335,ship++_shctr_9,config1,0.42728,100000003,234038584,1105151,343510,761641,614443,161613,452830,245232,68530,176702,0,0,0,245476,113367,132109
336,ship++_shctr_9,config1,0.39588,100000003,252601699,405077,381444,23633,285435,267479,17956,34070,28835,5235,0,0,0,85572,85130,442
337,ship++_shctr_9,config1,0.433609,100000003,230622283,2675520,63279,2612241,1680645,8754,1671891,136848,10729,126119,0,0,0,858027,43796,814231
338,ship++_shctr_9,config1,0.502904,100000002,198845291,3572673,842507,2730166,2180514,502987,1677527,629127,125033,504094,0,0,0,763032,214487,548545
339,ship++_shctr_9,config1,0.236039,100000001,423659344,1985077,268044,1717033,1160722,111630,1049092,340444,39040,301404,0,0,0,483911,117374,366537
340,ship++_shctr_9,config1,0.613514,100000000,162995377,1575106,842582,732524,1332841,651020,681821,103775,77931,25844,0,0,0,138490,113631,24859
341,ship++_shctr_9,config1,0.127657,100000001,783347630,6966714,2703919,4262795,2413974,468288,1945686,1812772,668836,1143936,0,0,0,2739968,1566795,1173173
342,ship++_shctr_9,config1,0.747006,100000003,133867783,1134871,1001852,133019,519856,460950,58906,292434,223403,69031,0,0,0,322581,317499,5082
343,ship++_shctr_9,config1,0.115509,100000001,865733438,11193216,5093165,6100051,8987783,3650902,5336881,195614,128555,67059,0,0,0,2009819,1313708,696111
344,ship++_shctr_9,config1,1.0265,100000001,97418165,381989,15257,366732,315489,5725,309764,3447,1,3446,0,0,0,63053,9531,53522
345,ship++_shctr_9,config1,0.282283,100000003,354254960,7007030,3693003,3314027,4052523,1707736,2344787,856737,322841,533896,0,0,0,2097770,1662426,435344
346,ship++_shctr_9,config1,1.46197,100000003,68400912,1133161,1046467,86694,790337,733221,57116,47630,19491,28139,0,0,0,295194,293755,1439
347,ship++_shctr_9,config1,0.439855,100000003,227347387,2838711,65423,2773288,1956031,11744,1944287,140009,0,140009,0,0,0,742671,53679,688992
348,ship++_shctr_9,config1,0.316548,100000000,315907558,2825480,2583279,242201,2094626,1860186,234440,16394,16029,365,0,0,0,714460,707064,7396
349,ship++_shctr_9,config1,0.0843544,100000000,1185474369,14619467,7804499,6814968,14276864,7560835,6716029,25871,16954,8917,0,0,0,316732,226710,90022
350,ship++_shctr_9,config1,0.598823,100000000,166994115,1490751,455767,1034984,835381,194470,640911,219225,35463,183762,0,0,0,436145,225834,210311
351,ship++_shctr_9,config1,0.323695,100000002,308933001,5290132,2791810,2498322,3127292,1399585,1727707,652034,256736,395298,0,0,0,1510806,1135489,375317
352,ship++_shctr_9,config1,2.07426,100000001,48209981,1896,9,1887,1706,0,1706,181,0,181,0,0,0,9,9,0
353,ship++_shctr_9,config1,0.553272,100000000,180743000,119555,22851,96704,80540,2977,77563,1075,170,905,0,0,0,37940,19704,18236
354,ship++_shctr_9,config1,0.815427,100000002,122635192,991022,710445,280577,696690,505790,190900,102176,40193,61983,0,0,0,192156,164462,27694
355,ship++_shctr_9,config1,1.4703,100000003,68013170,827374,620627,206747,730855,524580,206275,414,393,21,0,0,0,96105,95654,451
356,ship++_shctr_9,config1,0.516238,100000003,193708972,2445955,76093,2369862,1321299,2008,1319291,423300,6190,417110,0,0,0,701356,67895,633461
357,ship++_shctr_9,config2,0.459706,100000000,217530168,1164132,328623,835509,21801,2189,19612,264086,77126,186960,612140,133881,478259,266105,115427,150678
358,ship++_shctr_9,config2,0.725208,100000001,137891538,42522,7078,35444,13577,394,13183,3352,12,3340,17694,474,17220,7899,6198,1701
359,ship++_shctr_9,config2,0.644833,100000001,155078843,5794296,1434221,4360075,416993,18188,398805,2473095,380260,2092835,431095,23671,407424,2473113,1012102,1461011
360,ship++_shctr_9,config2,0.410569,100000000,243564378,157868,133925,23943,71023,61828,9195,11273,5616,5657,50719,41858,8861,24853,24623,230
361,ship++_shctr_9,config2,0.606159,100000003,164973333,5145109,260406,4884703,521192,122215,398977,18,0,18,3246598,56084,3190514,1377301,82107,1295194
362,ship++_shctr_9,config2,1.42315,100000003,70266494,832279,71747,760532,26431,12539,13892,201506,8101,193405,401369,17662,383707,202973,33445,169528
363,ship++_shctr_9,config2,0.665839,100000000,150186526,5497368,1379095,4118273,393928,18384,375544,2345808,348512,1997296,411495,23507,387988,2346137,988692,1357445
364,ship++_shctr_9,config2,0.379755,100000000,263327904,8713583,4824145,3889438,2236950,1104649,1132301,764918,275996,488922,3551246,1638471,1912775,2160469,1805029,355440
365,ship++_shctr_9,config2,1.2255,100000003,81599366,1445927,851484,594443,118918,100646,18272,121984,120604,1380,1076629,502088,574541,128396,128146,250
366,ship++_shctr_9,config2,1.04682,100000000,95527502,1574046,834848,739198,202205,167800,34405,111348,109870,1478,1127336,426106,701230,133157,131072,2085
367,ship++_shctr_9,config2,0.109721,100000002,911402771,21077709,9762111,11315598,9505393,5916071,3589322,164328,54008,110320,9645106,2290954,7354152,1762882,1501078,261804
368,ship++_shctr_9,config2,1.35966,100000002,73547882,631972,293556,338416,37138,23618,13520,152072,75870,76202,286951,94796,192155,155811,99272,56539
369,ship++_shctr_9,config2,0.254586,100000000,392794710,4309283,1371742,2937541,1523120,449961,1073159,250171,88102,162069,1529944,187153,1342791,1006048,646526,359522
370,ship++_shctr_9,config2,0.636566,100000000,157092931,4600620,1063369,3537251,465961,123230,342731,742581,95817,646764,2291859,501778,1790081,1100219,342544,757675
371,ship++_shctr_9,config2,0.609113,100000001,164173017,4812618,562344,4250274,461870,41073,420797,126472,117264,9208,2859985,129237,2730748,1364291,274770,1089521
372,ship++_shctr_9,config2,0.557103,100000003,179499871,4917133,281823,4635310,1165495,58122,1107373,24,24,0,2224916,103299,2121617,1526698,120378,1406320
373,ship++_shctr_9,config2,0.482824,100000001,207114988,4047262,225173,3822089,834622,34689,799933,24,16,8,2172180,93959,2078221,1040436,96509,943927
374,ship++_shctr_9,config2,0.37478,100000001,266823074,4665375,2423907,2241468,2182967,2033349,149618,24957,11893,13064,2377082,315031,2062051,80369,63634,16735
375,ship++_shctr_9,config2,0.498728,100000001,200510303,479217,207513,271704,108310,56842,51468,72099,10548,61551,138948,57863,81085,159860,82260,77600
376,ship++_shctr_9,config2,0.446008,100000000,224211428,13010445,10700732,2309713,5290176,4387265,902911,0,0,0,6807286,5404170,1403116,912983,909297,3686
377,ship++_shctr_9,config2,0.462925,100000003,216017497,3282860,1552360,1730500,1561740,1377291,184449,5220,2696,2524,1699052,163630,1535422,16848,8743,8105
378,ship++_shctr_9,config2,0.621255,100000003,160964496,6072353,1526128,4546225,447595,20474,427121,2591714,387200,2204514,441097,24804,416293,2591947,1093650,1498297
379,ship++_shctr_9,config2,0.682236,100000000,146576829,1089043,142070,946973,57702,8763,48939,201523,1450,200073,601299,48455,552844,228519,83402,145117
380,ship++_shctr_9,config2,0.39757,100000000,251528287,656700,614159,42541,310898,302881,8017,30806,26548,4258,212715,183044,29671,102281,101686,595
381,ship++_shctr_9,config2,0.742146,100000003,134744418,21346127,21272377,73750,165896,131117,34779,10463422,10457724,5698,183321,150222,33099,10533488,10533314,174
382,ship++_shctr_9,config2,0.71113,100000000,140621345,3756885,1236519,2520366,404497,126608,277889,463745,173982,289763,2139465,599415,1540050,749178,336514,412664
383,ship++_shctr_9,config2,0.897101,100000000,111470192,2346525,2095912,250613,882490,863558,18932,180742,104178,76564,1098435,959865,138570,184858,168311,16547
384,ship++_shctr_9,config2,0.46985,100000003,212833753,1168815,336955,831860,25183,2590,22593,265309,76415,188894,610976,141215,469761,267347,116735,150612
385,ship++_shctr_9,config2,0.519614,100000000,192450510,3801551,126410,3675141,655583,37836,617747,20,18,2,2133843,72206,2061637,1012105,16350,995755
386,ship++_shctr_9,config2,0.484486,100000003,206404513,1107493,335559,771934,22985,3601,19384,245174,66995,178179,593824,161885,431939,245510,103078,142432
387,ship++_shctr_9,config2,0.398934,100000003,250668336,635536,575012,60524,295068,285351,9717,30364,26099,4265,206822,161535,45287,103282,102027,1255
388,ship++_shctr_9,config2,0.580286,100000003,172328889,3300884,85178,3215706,970637,247,970390,136847,15324,121523,1335311,10425,1324886,858089,59182,798907
389,ship++_shctr_9,config2,0.732448,100000001,136528542,3582842,784344,2798498,297777,69975,227802,622474,117661,504813,1899193,353279,1545914,763398,243429,519969
390,ship++_shctr_9,config2,0.264482,100000001,378097660,2541232,357481,2183751,647307,76064,571243,278235,39596,238639,1132023,92665,1039358,483667,149156,334511
391,ship++_shctr_9,config2,0.882211,100000000,113351607,1795701,732627,1063074,315505,202210,113295,99610,75315,24295,1239168,328528,910640,141418,126574,14844
392,ship++_shctr_9,config2,0.13771,100000001,726161417,8753310,2617283,6136027,1888913,476675,1412238,1828654,406726,1421928,2272907,178761,2094146,2762836,1555121,1207715
393,ship++_shctr_9,config2,0.77025,100000003,129828033,1571482,1426664,144818,429759,407117,22642,294146,234432,59714,521615,466332,55283,325962,318783,7179
394,ship++_shctr_9,config2,0.121019,100000001,826318233,18752377,8252402,10499975,8468764,4412379,4056385,206422,69234,137188,7969709,2093393,5876316,2107482,1677396,430086
395,ship++_shctr_9,config2,1.29397,100000001,77281723,382567,18343,364224,27952,435,27517,3434,3,3431,287945,4522,283423,63236,13383,49853
396,ship++_shctr_9,config2,0.366668,100000003,272725979,8730162,4655474,4074688,2230081,1053843,1176238,871481,337285,534196,3453705,1518092,1935613,2174895,1746254,428641
397,ship++_shctr_9,config2,1.8005,100000000,55540104,1161495,1006577,154918,133712,127651,6061,47551,19715,27836,680409,561260,119149,299823,297951,1872
398,ship++_shctr_9,config2,0.557498,100000003,179372842,3481389,61679,3419710,1002050,47,1002003,140009,0,140009,1596659,9770,1586889,742671,51862,690809
399,ship++_shctr_9,config2,0.339748,100000000,294335953,5227648,4929236,298412,2121362,1999872,121490,29854,29574,280,2267258,2099541,167717,809174,800249,8925
400,ship++_shctr_9,config2,0.124543,100000000,802932601,26950693,13345741,13604952,11714274,9919168,1795106,27346,10726,16620,14875359,3152518,11722841,333714,263329,70385
401,ship++_shctr_9,config2,0.781267,100000000,127997282,1495361,467827,1027534,89254,24458,64796,219210,36194,183016,750753,158816,591937,436144,248359,187785
402,ship++_shctr_9,config2,0.404153,100000003,247430865,6596475,3292090,3304385,1695156,770877,924279,658482,243940,414542,2682194,1097469,1584725,1560643,1179804,380839
403,ship++_shctr_9,config2,2.07905,100000001,48098913,2155,25,2130,803,0,803,129,0,129,1200,2,1198,23,23,0
404,ship++_shctr_9,config2,0.565164,100000002,176939873,134697,36109,98588,14850,4263,10587,1241,336,905,79509,9783,69726,39097,21727,17370
405,ship++_shctr_9,config2,0.915475,100000002,109232897,1373525,1063128,310397,396203,350062,46141,104382,42736,61646,675958,510841,165117,196982,159489,37493
406,ship++_shctr_9,config2,1.972,100000000,50710039,865128,559929,305199,110523,92839,17684,417,405,12,655876,375039,280837,98312,91646,6666
407,ship++_shctr_9,config2,0.678674,100000003,147346064,2872436,74643,2797793,739080,101,738979,423298,7234,416064,1009340,1777,1007563,700718,65531,635187
408,ship++_shctr_8,config1,0.407501,100000000,245398333,1162158,362688,799470,632028,156247,475781,264148,78022,186126,0,0,0,265982,128419,137563
409,ship++_shctr_8,config1,0.723638,100000001,138190642,32513,7872,24641,21583,407,21176,3395,1,3394,0,0,0,7535,7464,71
410,ship++_shctr_8,config1,0.558019,100000001,179205462,5752313,1421090,4331223,806178,47,806131,2473062,375611,2097451,0,0,0,2473073,1045432,1427641
411,ship++_shctr_8,config1,0.40945,100000000,244230268,81693,61811,19882,53416,39658,13758,10648,4526,6122,0,0,0,17629,17627,2
412,ship++_shctr_8,config1,0.347515,100000003,287757581,4687846,807673,3880173,3310972,703689,2607283,20,0,20,0,0,0,1376854,103984,1272870
413,ship++_shctr_8,config1,1.13967,100000003,87744962,789892,120873,669019,401403,95369,306034,194182,906,193276,0,0,0,194307,24598,169709
414,ship++_shctr_8,config1,0.578841,100000000,172758878,5455658,1309735,4145923,763535,147,763388,2345906,378330,1967576,0,0,0,2346217,931258,1414959
415,ship++_shctr_8,config1,0.286918,100000000,348531781,6993459,3899424,3094035,4167410,1833858,2333552,751801,303529,448272,0,0,0,2074248,1762037,312211
416,ship++_shctr_8,config1,0.888898,100000002,112498846,1399110,999842,399268,1148253,753734,394519,122689,118394,4295,0,0,0,128168,127714,454
417,ship++_shctr_8,config1,0.760136,100000002,131555415,1449308,983991,465317,1202503,751333,451170,114013,104069,9944,0,0,0,132792,128589,4203
418,ship++_shctr_8,config1,0.0924615,100000002,1081531579,12167936,5955707,6212229,10389080,4751059,5638021,150267,90413,59854,0,0,0,1628589,1114235,514354
419,ship++_shctr_8,config1,1.08304,100000002,92332423,613106,286843,326263,304677,113542,191135,151947,75540,76407,0,0,0,156482,97761,58721
420,ship++_shctr_8,config1,0.234815,100000000,425866818,3244335,1273780,1970555,1933191,496568,1436623,328151,102410,225741,0,0,0,982993,674802,308191
421,ship++_shctr_8,config1,0.464596,100000000,215240859,4478735,1155165,3323570,2621667,727266,1894401,760058,101031,659027,0,0,0,1097010,326868,770142
422,ship++_shctr_8,config1,0.369889,100000001,270351393,4564551,1039955,3524596,3073734,655567,2418167,126461,110811,15650,0,0,0,1364356,273577,1090779
423,ship++_shctr_8,config1,0.445223,100000001,224606309,4917103,211540,4705563,3390381,132642,3257739,24,24,0,0,0,0,1526698,78874,1447824
424,ship++_shctr_8,config1,0.347126,100000003,288080027,4047234,256611,3790623,3006773,158874,2847899,24,18,6,0,0,0,1040437,97719,942718
425,ship++_shctr_8,config1,0.368796,100000001,271152376,2613321,2332348,280973,2495346,2235081,260265,37610,21729,15881,0,0,0,80365,75538,4827
426,ship++_shctr_8,config1,0.490938,100000000,203691854,373289,145885,227404,144397,55032,89365,71290,18667,52623,0,0,0,157602,72186,85416
427,ship++_shctr_8,config1,0.397861,100000001,251344350,2498857,1059794,1439063,2298896,860672,1438224,0,0,0,0,0,0,199961,199122,839
428,ship++_shctr_8,config1,0.457592,100000003,218535149,1769069,1368748,400321,1739414,1354066,385348,12908,2529,10379,0,0,0,16747,12153,4594
429,ship++_shctr_8,config1,0.549443,100000003,182002336,6027265,1588158,4439107,843450,156,843294,2591802,463839,2127963,0,0,0,2592013,1124163,1467850
430,ship++_shctr_8,config1,0.42977,100000003,232682389,1058894,130757,928137,632847,49180,583667,201034,793,200241,0,0,0,225013,80784,144229
431,ship++_shctr_8,config1,0.394451,100000000,253516974,411671,390245,21426,296216,280445,15771,32929,27654,5275,0,0,0,82526,82146,380
432,ship++_shctr_8,config1,0.733262,100000003,136376904,21200174,21146044,54130,194764,150679,44085,10471722,10461785,9937,0,0,0,10533688,10533580,108
433,ship++_shctr_8,config1,0.495182,100000000,201946104,3679358,1373486,2305872,2465978,862290,1603688,467655,176382,291273,0,0,0,745725,334814,410911
434,ship++_shctr_8,config1,0.830038,100000000,120476475,1432059,1206319,225740,1067512,937973,129539,180724,99712,81012,0,0,0,183823,168634,15189
435,ship++_shctr_8,config1,0.41555,100000003,240644781,1165598,361365,804233,633144,158173,474971,265372,74120,191252,0,0,0,267082,129072,138010
436,ship++_shctr_8,config1,0.381508,100000001,262117606,3801525,112400,3689125,2789401,96457,2692944,20,20,0,0,0,0,1012104,15923,996181
437,ship++_shctr_8,config1,0.426619,100000003,234400960,1105151,340469,764682,614443,158947,455496,245232,68356,176876,0,0,0,245476,113166,132310
438,ship++_shctr_8,config1,0.395895,100000003,252592494,405077,381441,23636,285435,267489,17946,34070,28830,5240,0,0,0,85572,85122,450
439,ship++_shctr_8,config1,0.433609,100000003,230622283,2675520,63279,2612241,1680645,8754,1671891,136848,10729,126119,0,0,0,858027,43796,814231
440,ship++_shctr_8,config1,0.50021,100000002,199916129,3572713,849519,2723194,2180501,510581,1669920,629153,120828,508325,0,0,0,763059,218110,544949
441,ship++_shctr_8,config1,0.236044,100000001,423648956,1985144,268208,1716936,1160646,111835,1048811,340521,39000,301521,0,0,0,483977,117373,366604
442,ship++_shctr_8,config1,0.610988,100000000,163669395,1575109,839994,735115,1332846,649027,683819,103774,75707,28067,0,0,0,138489,115260,23229
443,ship++_shctr_8,config1,0.128768,100000001,776590286,6966718,2761910,4204808,2413974,503610,1910364,1812774,721186,1091588,0,0,0,2739970,1537114,1202856
444,ship++_shctr_8,config1,0.747093,100000003,133852095,1134847,1002309,132538,519853,461045,58808,292423,223549,68874,0,0,0,322571,317715,4856
445,ship++_shctr_8,config1,0.115356,100000001,866878754,11193201,5089938,6103263,8987770,3643736,5344034,195620,123246,72374,0,0,0,2009811,1322956,686855
446,ship++_shctr_8,config1,1.02658,100000001,97410968,381989,15295,366694,315489,5754,309735,3447,1,3446,0,0,0,63053,9540,53513
447,ship++_shctr_8,config1,0.282238,100000003,354310357,7007014,3650595,3356419,4052511,1695724,2356787,856735,320440,536295,0,0,0,2097768,1634431,463337
448,ship++_shctr_8,config1,1.46225,100000003,68387767,1133161,1046481,86680,790337,733393,56944,47630,19441,28189,0,0,0,295194,293647,1547
449,ship++_shctr_8,config1,0.439855,100000003,227347387,2838711,65423,2773288,1956031,11744,1944287,140009,0,140009,0,0,0,742671,53679,688992
450,ship++_shctr_8,config1,0.316498,100000000,315957700,2825480,2583432,242048,2094626,1859855,234771,16394,16027,367,0,0,0,714460,707550,6910
451,ship++_shctr_8,config1,0.0843721,100000000,1185225189,14619465,7803342,6816123,14276863,7562003,6714860,25870,16962,8908,0,0,0,316732,224377,92355
452,ship++_shctr_8,config1,0.599254,100000000,166874238,1490753,458633,1032120,835382,195243,640139,219225,36647,182578,0,0,0,436146,226743,209403
453,ship++_shctr_8,config1,0.323359,100000002,309253939,5290168,2789055,2501113,3127304,1395924,1731380,652041,255259,396782,0,0,0,1510823,1137872,372951
454,ship++_shctr_8,config1,2.07426,100000001,48209981,1896,9,1887,1706,0,1706,181,0,181,0,0,0,9,9,0
455,ship++_shctr_8,config1,0.553272,100000000,180743000,119555,22851,96704,80540,2977,77563,1075,170,905,0,0,0,37940,19704,18236
456,ship++_shctr_8,config1,0.815189,100000002,122670961,991023,713636,277387,696691,507137,189554,102176,39944,62232,0,0,0,192156,166555,25601
457,ship++_shctr_8,config1,1.48048,100000003,67545477,827374,624688,202686,730855,528689,202166,414,393,21,0,0,0,96105,95606,499
458,ship++_shctr_8,config1,0.516238,100000003,193708972,2445955,76093,2369862,1321299,2008,1319291,423300,6190,417110,0,0,0,701356,67895,633461
459,ship++_shctr_8,config2,0.459694,100000000,217535939,1164160,328210,835950,21824,2216,19608,264086,77066,187020,612143,133480,478663,266107,115448,150659
460,ship++_shctr_8,config2,0.725208,100000001,137891538,42522,7078,35444,13577,394,13183,3352,12,3340,17694,474,17220,7899,6198,1701
461,ship++_shctr_8,config2,0.646938,100000001,154574401,5795988,1405518,4390470,417690,18915,398775,2473082,387927,2085155,432114,24615,407499,2473102,974061,1499041
462,ship++_shctr_8,config2,0.410569,100000000,243564378,157868,133925,23943,71023,61828,9195,11273,5616,5657,50719,41858,8861,24853,24623,230
463,ship++_shctr_8,config2,0.606462,100000003,164890820,5145137,267687,4877450,521239,121869,399370,18,0,18,3246577,64190,3182387,1377303,81628,1295675
464,ship++_shctr_8,config2,1.42274,100000003,70286831,832780,71136,761644,26636,12710,13926,201585,8130,193455,401492,17025,384467,203067,33271,169796
465,ship++_shctr_8,config2,0.674449,100000000,148269163,5491754,1439886,4051868,391115,15763,375352,2345799,400657,1945142,408706,20496,388210,2346134,1002970,1343164
466,ship++_shctr_8,config2,0.379708,100000000,263359971,8713609,4830104,3883505,2236827,1104593,1132234,764933,276950,487983,3551353,1642133,1909220,2160496,1806428,354068
467,ship++_shctr_8,config2,1.22728,100000003,81480911,1445930,860232,585698,118922,100297,18625,121984,120567,1417,1076628,511203,565425,128396,128165,231
468,ship++_shctr_8,config2,1.04564,100000000,95635608,1574043,832533,741510,202198,167660,34538,111344,109784,1560,1127348,423878,703470,133153,131211,1942
469,ship++_shctr_8,config2,0.109427,100000002,913854202,21078418,9754443,11323975,9505836,5900448,3605388,164357,53796,110561,9645283,2298133,7347150,1762942,1502066,260876
470,ship++_shctr_8,config2,1.35877,100000002,73596116,631971,292124,339847,37130,23237,13893,152071,75869,76202,286961,93964,192997,155809,99054,56755
471,ship++_shctr_8,config2,0.255254,100000000,391766129,4309295,1383551,2925744,1522879,453932,1068947,250226,87906,162320,1530149,188023,1342126,1006041,653690,352351
472,ship++_shctr_8,config2,0.636684,100000000,157063877,4599500,1078733,3520767,466050,125066,340984,742960,95996,646964,2290175,506671,1783504,1100315,351000,749315
473,ship++_shctr_8,config2,0.608725,100000001,164277665,4812401,566672,4245729,461767,41193,420574,126472,117199,9273,2859868,133083,2726785,1364294,275197,1089097
474,ship++_shctr_8,config2,0.556269,100000003,179769102,4917133,276428,4640705,1164863,57784,1107079,24,24,0,2225548,94167,2131381,1526698,124453,1402245
475,ship++_shctr_8,config2,0.483027,100000001,207027875,4047262,229271,3817991,834672,34350,800322,24,12,12,2172130,95059,2077071,1040436,99850,940586
476,ship++_shctr_8,config2,0.374487,100000001,267032056,4665143,2414136,2251007,2182720,2027449,155271,24953,11865,13088,2377101,312817,2064284,80369,62005,18364
477,ship++_shctr_8,config2,0.499027,100000001,200390097,479231,279262,199969,108311,57664,50647,72100,36824,35276,138958,57362,81596,159862,127412,32450
478,ship++_shctr_8,config2,0.446032,100000000,224199012,13010029,10700471,2309558,5289770,4386956,902814,0,0,0,6807200,5404130,1403070,913059,909385,3674
479,ship++_shctr_8,config2,0.462791,100000003,216080158,3282906,1549447,1733459,1562178,1360194,201984,5220,2695,2525,1698660,178232,1520428,16848,8326,8522
480,ship++_shctr_8,config2,0.635114,100000003,157452106,6064047,1598274,4465773,443593,16674,426919,2591751,480962,2110789,436731,20235,416496,2591972,1080403,1511569
481,ship++_shctr_8,config2,0.682236,100000000,146576829,1089043,142070,946973,57702,8763,48939,201523,1450,200073,601299,48455,552844,228519,83402,145117
482,ship++_shctr_8,config2,0.397523,100000000,251557597,656698,613722,42976,310899,302707,8192,30806,26516,4290,212712,182833,29879,102281,101666,615
483,ship++_shctr_8,config2,0.74215,100000003,134743726,21346126,21272541,73585,165897,131119,34778,10463422,10457724,5698,183319,150382,32937,10533488,10533316,172
484,ship++_shctr_8,config2,0.7093,100000000,140983984,3757028,1213311,2543717,404560,125191,279369,463737,173970,289767,2139549,576234,1563315,749182,337916,411266
485,ship++_shctr_8,config2,0.896724,100000000,111516976,2346556,2096617,249939,882465,862782,19683,180705,106275,74430,1098564,959597,138967,184822,167963,16859
486,ship++_shctr_8,config2,0.469845,100000003,212836157,1168854,335823,833031,25274,2603,22671,265309,76458,188851,610925,140451,470474,267346,116311,151035
487,ship++_shctr_8,config2,0.519628,100000000,192445256,3801551,124712,3676839,655605,37855,617750,20,20,0,2133821,70256,2063565,1012105,16581,995524
488,ship++_shctr_8,config2,0.48448,100000003,206406892,1107595,333860,773735,23073,3665,19408,245174,66313,178861,593838,160792,433046,245510,103090,142420
489,ship++_shctr_8,config2,0.398984,100000003,250636807,635545,577063,58482,295071,285010,10061,30364,26044,4320,206828,163971,42857,103282,102038,1244
490,ship++_shctr_8,config2,0.580286,100000003,172328889,3300884,85178,3215706,970637,247,970390,136847,15324,121523,1335311,10425,1324886,858089,59182,798907
491,ship++_shctr_8,config2,0.731164,100000001,136768155,3582841,776946,2805895,296884,65970,230914,622471,116769,505702,1900065,352684,1547381,763421,241523,521898
492,ship++_shctr_8,config2,0.264246,100000001,378435453,2541271,349186,2192085,647237,71930,575307,278333,39696,238637,1132025,90937,1041088,483676,146623,337053
493,ship++_shctr_8,config2,0.880316,100000000,113595562,1795727,739916,1055811,315522,204549,110973,99616,76925,22691,1239169,331327,907842,141420,127115,14305
494,ship++_shctr_8,config2,0.138199,100000001,723592717,8752939,2617702,6135237,1889096,493024,1396072,1828639,394227,1434412,2272392,187914,2084478,2762812,1542537,1220275
495,ship++_shctr_8,config2,0.770155,100000003,129844036,1571473,1426099,145374,429749,407093,22656,294153,234002,60151,521605,466603,55002,325966,318401,7565
496,ship++_shctr_8,config2,0.121178,100000001,825234300,18752667,8244950,10507717,8468575,4418013,4050562,206389,69787,136602,7970239,2084150,5886089,2107464,1673000,434464
497,ship++_shctr_8,config2,1.29397,100000001,77281723,382567,18343,364224,27952,435,27517,3434,3,3431,287945,4522,283423,63236,13383,49853
498,ship++_shctr_8,config2,0.366006,100000003,273219644,8728833,4611990,4116843,2229716,1049155,1180561,871510,326905,544605,3452695,1516233,1936462,2174912,1719697,455215
499,ship++_shctr_8,config2,1.80185,100000000,55498368,1161497,1017772,143725,133708,127520,6188,47548,19214,28334,680416,573326,107090,299825,297712,2113
500,ship++_shctr_8,config2,0.557498,100000003,179372842,3481389,61679,3419710,1002050,47,1002003,140009,0,140009,1596659,9770,1586889,742671,51862,690809
501,ship++_shctr_8,config2,0.339675,100000000,294399097,5227582,4925601,301981,2121368,1999549,121819,29854,29581,273,2267188,2097461,169727,809172,799010,10162
502,ship++_shctr_8,config2,0.124048,100000000,806138285,26951940,13376305,13575635,11714901,9886682,1828219,27349,10516,16833,14875966,3202448,11673518,333724,276659,57065
503,ship++_shctr_8,config2,0.781264,100000000,127997682,1495355,472140,1023215,89188,23861,65327,219210,37559,181651,750813,159201,591612,436144,251519,184625
504,ship++_shctr_8,config2,0.404445,100000003,247252285,6596804,3321479,3275325,1693972,764908,929064,658485,256465,402020,2683695,1112166,1571529,1560652,1187940,372712
505,ship++_shctr_8,config2,2.07905,100000001,48098913,2155,25,2130,803,0,803,129,0,129,1200,2,1198,23,23,0
506,ship++_shctr_8,config2,0.565157,100000002,176942053,134694,35814,98880,14833,4250,10583,1241,336,905,79523,9803,69720,39097,21425,17672
507,ship++_shctr_8,config2,0.9152,100000002,109265733,1373523,1059532,313991,396208,349364,46844,104384,40674,63710,675949,510738,165211,196982,158756,38226
508,ship++_shctr_8,config2,1.97766,100000000,50564760,865126,586594,278532,110527,92674,17853,417,404,13,655870,406658,249212,98312,86858,11454
509,ship++_shctr_8,config2,0.678674,100000003,147346064,2872436,74643,2797793,739080,101,738979,423298,7234,416064,1009340,1777,1007563,700718,65531,635187
510,lru,config1,0.390344,100000000,256184285,1162160,267721,894439,632030,1198,630832,264148,880,263268,0,0,0,265982,265643,339
511,lru,config1,0.723639,100000001,138190494,32513,7942,24571,21583,406,21177,3395,1,3394,0,0,0,7535,7535,0
512,lru,config1,0.509711,100000001,196189486,5752329,2527086,3225243,806178,0,806178,2473071,54099,2418972,0,0,0,2473080,2472987,93
513,lru,config1,0.409449,100000000,244230448,81693,61813,19880,53416,39658,13758,10648,4526,6122,0,0,0,17629,17629,0
514,lru,config1,0.317132,100000003,315325626,4687854,1592778,3095076,3310980,216077,3094903,20,0,20,0,0,0,1376854,1376701,153
515,lru,config1,1.14101,100000003,87642009,789890,290928,498962,401404,96008,305396,194179,917,193262,0,0,0,194307,194003,304
516,lru,config1,0.526451,100000000,189951210,5455659,2401928,3053731,763533,49,763484,2345909,55777,2290132,0,0,0,2346217,2346102,115
517,lru,config1,0.265136,100000000,377165163,6993590,3603901,3389689,4167508,1281047,2886461,751792,248584,503208,0,0,0,2074290,2074270,20
518,lru,config1,0.692734,100000002,144355481,1399116,551292,847824,1148259,350914,797345,122689,72213,50476,0,0,0,128168,128165,3
519,lru,config1,0.578831,100000002,172761969,1449276,378126,1071150,1202477,206336,996141,114007,39003,75004,0,0,0,132792,132787,5
520,lru,config1,0.0787944,100000002,1269125563,12167939,4625808,7542131,10388997,2950589,7438408,150417,47870,102547,0,0,0,1628525,1627349,1176
521,lru,config1,1.08506,100000002,92160704,613109,349542,263567,304676,116795,187881,151948,76322,75626,0,0,0,156485,156425,60
522,lru,config1,0.234695,100000000,426084338,3244339,1554331,1690008,1933674,492063,1441611,327662,79693,247969,0,0,0,983003,982575,428
523,lru,config1,0.459785,100000000,217493064,4478157,1878319,2599838,2621175,693491,1927684,760557,89531,671026,0,0,0,1096425,1095297,1128
524,lru,config1,0.334717,100000001,298759809,4564558,1594737,2969821,3073739,141312,2932427,126461,89148,37313,0,0,0,1364358,1364277,81
525,lru,config1,0.428219,100000001,233525569,4917103,1526698,3390405,3390381,0,3390381,24,0,24,0,0,0,1526698,1526698,0
526,lru,config1,0.333528,100000003,299824840,4047234,1040437,3006797,3006773,0,3006773,24,0,24,0,0,0,1040437,1040437,0
527,lru,config1,0.354817,100000001,281835757,2613318,1941187,672131,2495334,1840207,655127,37619,20615,17004,0,0,0,80365,80365,0
528,lru,config1,0.495961,100000000,201628940,373290,269193,104097,144397,71491,72906,71290,40099,31191,0,0,0,157603,157603,0
529,lru,config1,0.400682,100000001,249574611,2498554,1069913,1428641,2298797,874406,1424391,0,0,0,0,0,0,199757,195507,4250
530,lru,config1,0.425099,100000003,235239362,1769069,772331,996738,1739414,753503,985911,12908,2081,10827,0,0,0,16747,16747,0
531,lru,config1,0.493596,100000003,202594862,6027256,2653258,3373998,843448,78,843370,2591800,61301,2530499,0,0,0,2592008,2591879,129
532,lru,config1,0.433761,100000003,230541493,1058894,273985,784909,632847,48441,584406,201034,794,200240,0,0,0,225013,224750,263
533,lru,config1,0.39433,100000000,253594862,411671,390078,21593,296216,279872,16344,32929,27682,5247,0,0,0,82526,82524,2
534,lru,config1,0.733295,100000003,136370714,21200174,21146166,54008,194764,150691,44073,10471722,10461787,9935,0,0,0,10533688,10533688,0
535,lru,config1,0.482811,100000000,207120394,3679323,1570810,2108513,2465956,708693,1757263,467650,119472,348178,0,0,0,745717,742645,3072
536,lru,config1,0.817881,100000000,122267185,1432065,1195628,236437,1067514,910707,156807,180726,101098,79628,0,0,0,183825,183823,2
537,lru,config1,0.396365,100000003,252292982,1165608,269879,895729,633144,2440,630704,265372,693,264679,0,0,0,267092,266746,346
538,lru,config1,0.370933,100000001,269590508,3801525,1012104,2789421,2789401,0,2789401,20,0,20,0,0,0,1012104,1012104,0
539,lru,config1,0.407803,100000003,245216625,1105154,248274,856880,614444,2276,612168,245232,848,244384,0,0,0,245478,245150,328
540,lru,config1,0.395763,100000003,252676475,405075,381765,23310,285435,266797,18638,34069,29399,4670,0,0,0,85571,85569,2
541,lru,config1,0.429053,100000003,233071680,2675520,858013,1817507,1680645,0,1680645,136848,0,136848,0,0,0,858027,858013,14
542,lru,config1,0.476073,100000002,210051656,3572660,999990,2572670,2180506,190093,1990413,629126,50785,578341,0,0,0,763028,759112,3916
543,lru,config1,0.229598,100000001,435543621,1984037,524184,1459853,1160324,34532,1125792,340841,6817,334024,0,0,0,482872,482835,37
544,lru,config1,0.500711,100000000,199716010,1575104,297716,1277388,1332839,136687,1196152,103775,22907,80868,0,0,0,138490,138122,368
545,lru,config1,0.116654,100000001,857238813,6966703,2962598,4004105,2413962,93777,2320185,1812773,130950,1681823,0,0,0,2739968,2737871,2097
546,lru,config1,0.744774,100000003,134268888,1134860,1000585,134275,519852,455672,64180,292431,222336,70095,0,0,0,322577,322577,0
547,lru,config1,0.100438,100000001,995638931,11193215,4200452,6992763,8987645,2132608,6855037,195736,60120,135616,0,0,0,2009834,2007724,2110
548,lru,config1,1.02334,100000001,97719095,381989,66093,315896,315489,3095,312394,3447,1,3446,0,0,0,63053,62997,56
549,lru,config1,0.264043,100000003,378726191,7007057,3632626,3374431,4052524,1233561,2818963,856745,301294,555451,0,0,0,2097788,2097771,17
550,lru,config1,1.475,100000003,67796628,1133161,1050164,82997,790337,734979,55358,47630,19999,27631,0,0,0,295194,295186,8
551,lru,config1,0.435836,100000003,229444363,2838711,742780,2095931,1956031,116,1955915,140009,0,140009,0,0,0,742671,742664,7
552,lru,config1,0.316736,100000000,315720585,2825482,2592264,233218,2094627,1861734,232893,16394,16087,307,0,0,0,714461,714443,18
553,lru,config1,0.0705668,100000000,1417097301,14619404,5810215,8809189,14276802,5484691,8792111,25886,8845,17041,0,0,0,316716,316679,37
554,lru,config1,0.566832,100000000,176419026,1490753,474081,1016672,835383,26353,809030,219225,13188,206037,0,0,0,436145,434540,1605
555,lru,config1,0.298451,100000003,335063032,5290129,2556723,2733406,3127296,853818,2273478,652040,192241,459799,0,0,0,1510793,1510664,129
556,lru,config1,2.07426,100000001,48209981,1896,9,1887,1706,0,1706,181,0,181,0,0,0,9,9,0
557,lru,config1,0.553368,100000000,180711553,119558,41676,77882,80544,3581,76963,1075,170,905,0,0,0,37939,37925,14
558,lru,config1,0.799406,100000002,125092963,991022,695669,295353,696690,472179,224511,102176,31618,70558,0,0,0,192156,191872,284
559,lru,config1,1.59504,100000003,62694549,827374,713673,113701,730855,617181,113674,414,410,4,0,0,0,96105,96082,23
560,lru,config1,0.509538,100000003,196256165,2445955,701456,1744499,1321299,106,1321193,423300,0,423300,0,0,0,701356,701350,6
561,lru,config2,0.45848,100000000,218111792,1167234,272462,894772,25684,1340,24344,264086,815,263271,611364,4525,606839,266100,265782,318
562,lru,config2,0.725263,100000001,137881058,42522,8795,33727,13577,404,13173,3352,12,3340,17694,481,17213,7899,7898,1
563,lru,config2,0.587261,100000001,170282021,5804212,2578897,3225315,422086,22771,399315,2473104,54130,2418974,435898,28965,406933,2473124,2473031,93
564,lru,config2,0.410592,100000000,243551057,157868,134386,23482,71023,61898,9125,11273,5630,5643,50719,42005,8714,24853,24853,0
565,lru,config2,0.603059,100000003,165821240,5145137,1699671,3445466,520036,99272,420764,17,0,17,3247772,223266,3024506,1377312,1377133,179
566,lru,config2,1.45985,100000003,68500373,830734,331177,499557,25753,18220,7533,201122,7861,193261,401383,102991,298392,202476,202105,371
567,lru,config2,0.608469,100000000,164346804,5503280,2449477,3053803,397202,21089,376113,2345797,55665,2290132,414162,26718,387444,2346119,2346005,114
568,lru,config2,0.359733,100000000,277983621,8747425,4469548,4277877,2260739,896697,1364042,764966,238733,526233,3561028,1173460,2387568,2160692,2160658,34
569,lru,config2,1.10976,100000003,90109936,1445760,526834,918926,118766,38900,79866,122078,67344,54734,1076526,292208,784318,128390,128382,8
570,lru,config2,0.903523,100000002,110677842,1573656,327726,1245930,202256,41308,160948,111863,28072,83791,1126384,125224,1001160,133153,133122,31
571,lru,config2,0.100615,100000002,993884565,21081613,10362862,10718751,9507619,5094216,4413403,164380,57560,106820,9646754,3448641,6198113,1762860,1762445,415
572,lru,config2,1.37647,100000002,72649797,631884,367271,264613,37032,33310,3722,152074,76239,75835,286972,102006,184966,155806,155716,90
573,lru,config2,0.250878,100000000,398599627,4309283,1792932,2516351,1522194,372133,1150061,248844,60688,188156,1532199,354848,1177351,1006046,1005263,783
574,lru,config2,0.647197,100000000,154512571,4600747,1975899,2624848,463818,158849,304969,743629,88700,654929,2293425,629612,1663813,1099875,1098738,1137
575,lru,config2,0.599946,100000001,166681551,4812919,1581433,3231486,462133,7700,454433,126469,85775,40694,2860023,123750,2736273,1364294,1364208,86
576,lru,config2,0.533465,100000003,187453827,4917133,1526698,3390435,1217454,0,1217454,24,0,24,2172957,0,2172957,1526698,1526698,0
577,lru,config2,0.473027,100000001,211404608,4047262,1040436,3006826,835053,0,835053,24,0,24,2171749,0,2171749,1040436,1040436,0
578,lru,config2,0.331504,100000001,301655512,4673123,304805,4368318,2217620,105154,2112466,24920,1865,23055,2350214,117417,2232797,80369,80369,0
579,lru,config2,0.500206,100000001,199917764,479275,325683,153592,108318,60078,48240,72099,33789,38310,138994,71952,67042,159864,159864,0
580,lru,config2,0.464462,100000000,215302976,13011018,10805782,2205236,5290758,4489316,801442,0,0,0,6807158,5403733,1403425,913102,912733,369
581,lru,config2,0.417176,100000003,239706959,3289624,47145,3242479,1592274,19852,1572422,5220,236,4984,1675282,10209,1665073,16848,16848,0
582,lru,config2,0.5678,100000003,176118410,6081286,2707216,3374070,452222,24718,427504,2591720,61222,2530498,445394,29454,415940,2591950,2591822,128
583,lru,config2,0.680474,100000000,146956434,1089562,291448,798114,57488,8038,49450,201522,1497,200025,601984,53618,548366,228568,228295,273
584,lru,config2,0.395868,100000000,252609168,656694,614500,42194,310903,293040,17863,30806,25247,5559,212703,193945,18758,102282,102268,14
585,lru,config2,0.742212,100000003,134732416,21346126,21273695,72431,165899,131232,34667,10463422,10457726,5696,183317,151249,32068,10533488,10533488,0
586,lru,config2,0.713592,100000000,140136144,3757322,1646900,2110422,402166,151581,250585,463760,118489,345271,2142228,630720,1511508,749168,746110,3058
587,lru,config2,0.88814,100000000,112594881,2346296,2099433,246863,882496,852189,30307,180762,96603,84159,1098161,965769,132392,184877,184872,5
588,lru,config2,0.468356,100000003,213512603,1174483,278470,896013,31203,2714,28489,265309,685,264624,610627,8058,602569,267344,267013,331
589,lru,config2,0.506866,100000000,197290801,3801551,1012105,2789446,656541,0,656541,20,0,20,2132885,0,2132885,1012105,1012105,0
590,lru,config2,0.482491,100000003,207257755,1112910,255779,857131,28569,2450,26119,245174,833,244341,593656,7293,586363,245511,245203,308
591,lru,config2,0.397362,100000003,251659464,635539,588801,46738,295074,274853,20221,30365,25087,5278,206818,185591,21227,103282,103270,12
592,lru,config2,0.577433,100000003,173180279,3300884,858074,2442810,970601,0,970601,136847,0,136847,1335347,0,1335347,858089,858074,15
593,lru,config2,0.706312,100000001,141580532,3583439,1008961,2574478,297443,42304,255139,622457,48175,574282,1900366,159293,1741073,763173,759189,3984
594,lru,config2,0.25959,100000001,385223385,2540961,561747,1979214,648329,25503,622826,277788,19323,258465,1131991,34129,1097862,482853,482792,61
595,lru,config2,0.770382,100000000,129805669,1795305,312419,1482886,314284,58291,255993,100199,18868,81331,1239413,94889,1144524,141409,140371,1038
596,lru,config2,0.135285,100000001,739182576,8757454,3702161,5055293,1894069,434702,1459367,1828631,105134,1723497,2271947,400914,1871033,2762807,2761411,1396
597,lru,config2,0.765877,100000003,130569239,1570512,1423629,146883,429763,402759,27004,294162,219422,74740,520617,475478,45139,325970,325970,0
598,lru,config2,0.116483,100000001,858494196,18787133,8622625,10164508,8478507,3854836,4623671,206574,63813,142761,7993970,2597434,5396536,2108082,2106542,1540
599,lru,config2,1.29106,100000001,77455832,382568,66483,316085,27854,197,27657,3434,4,3430,288045,3112,284933,63235,63170,65
600,lru,config2,0.351338,100000003,284626048,8761252,4445269,4315983,2254139,849461,1404678,871504,273745,597759,3460602,1147091,2313511,2175007,2174972,35
601,lru,config2,1.84659,100000000,54153845,1161467,1078226,83241,133704,125416,8288,47550,19994,27556,680396,633010,47386,299817,299806,11
602,lru,config2,0.554715,100000003,180272600,3481391,742782,2738609,1002004,6,1001998,140009,0,140009,1596707,113,1596594,742671,742663,8
603,lru,config2,0.340539,100000000,293652401,5227725,4954044,273681,2121380,2004250,117130,29855,29601,254,2267317,2111038,156279,809173,809155,18
604,lru,config2,0.107139,100000000,933365143,26980406,15113890,11866516,11729785,8645002,3084783,27348,9879,17469,14889542,6125287,8764255,333731,333722,9
605,lru,config2,0.750038,100000000,133326510,1495337,474792,1020545,86447,1933,84514,219210,13110,206100,753539,25152,728387,436141,434597,1544
606,lru,config2,0.38984,100000003,256515665,6620953,3144836,3476117,1715645,567745,1147900,658480,168568,489912,2686146,848031,1838115,1560682,1560492,190
607,lru,config2,2.07905,100000001,48098913,2155,25,2130,803,0,803,129,0,129,1200,2,1198,23,23,0
608,lru,config2,0.565194,100000002,176930345,134856,55497,79359,14906,4426,10480,1242,341,901,79613,11727,67886,39095,39003,92
609,lru,config2,0.911461,100000002,109714022,1373526,1058150,315376,396205,341234,54971,104382,34230,70152,675959,485874,190085,196980,196812,168
610,lru,config2,2.11637,100000000,47250621,865119,749834,115285,110521,94108,16413,417,416,1,655869,557021,98848,98312,98289,23
611,lru,config2,0.670663,100000003,149106153,2872436,700812,2171624,739059,4,739055,423298,0,423298,1009361,96,1009265,700718,700712,6
612,ship++_leaders_32,config1,0.410339,100000000,243700835,1162159,352811,809348,632029,172058,459971,264148,52150,211998,0,0,0,265982,128603,137379
613,ship++_leaders_32,config1,0.723631,100000001,138192060,32513,7758,24755,21583,407,21176,3395,1,3394,0,0,0,7535,7350,185
614,ship++_leaders_32,config1,0.552712,100000001,180926169,5752319,1406391,4345928,806178,73,806105,2473066,351444,2121622,0,0,0,2473075,1054874,1418201
615,ship++_leaders_32,config1,0.40945,100000000,244230268,81693,61811,19882,53416,39658,13758,10648,4526,6122,0,0,0,17629,17627,2
616,ship++_leaders_32,config1,0.347169,100000003,288044450,4687846,803391,3884455,3310973,696763,2614210,20,0,20,0,0,0,1376853,106628,1270225
617,ship++_leaders_32,config1,1.13923,100000003,87778505,789838,121305,668533,401374,95138,306236,194169,895,193274,0,0,0,194295,25272,169023
618,ship++_leaders_32,config1,0.574427,100000000,174086625,5455684,1428308,4027376,763534,142,763392,2345922,372434,1973488,0,0,0,2346228,1055732,1290496
619,ship++_leaders_32,config1,0.286967,100000000,348472368,6993604,3980719,3012885,4167476,1856969,2310507,751808,298810,452998,0,0,0,2074320,1824940,249380
620,ship++_leaders_32,config1,0.88457,100000002,113049290,1399115,1000882,398233,1148258,755005,393253,122689,118205,4484,0,0,0,128168,127672,496
621,ship++_leaders_32,config1,0.754017,100000002,132623015,1449303,960406,488897,1202497,726051,476446,114014,105420,8594,0,0,0,132792,128935,3857
622,ship++_leaders_32,config1,0.0924504,100000002,1081661234,12167861,5958552,6209309,10389009,4749437,5639572,150277,92565,57712,0,0,0,1628575,1116550,512025
623,ship++_leaders_32,config1,1.08329,100000002,92311150,613108,288551,324557,304678,113722,190956,151946,75641,76305,0,0,0,156484,99188,57296
624,ship++_leaders_32,config1,0.234425,100000000,426576556,3244347,1230032,2014315,1932738,494400,1438338,328603,96019,232584,0,0,0,983006,639613,343393
625,ship++_leaders_32,config1,0.464403,100000000,215330394,4478641,1169849,3308792,2621587,730719,1890868,760135,100538,659597,0,0,0,1096919,338592,758327
626,ship++_leaders_32,config1,0.369282,100000001,270796078,4564554,1051548,3513006,3073734,648246,2425488,126461,115198,11263,0,0,0,1364359,288104,1076255
627,ship++_leaders_32,config1,0.445441,100000001,224496794,4917103,215484,4701619,3390381,134821,3255560,24,24,0,0,0,0,1526698,80639,1446059
628,ship++_leaders_32,config1,0.346996,100000003,288188133,4047234,257785,3789449,3006773,158195,2848578,24,18,6,0,0,0,1040437,99572,940865
629,ship++_leaders_32,config1,0.367172,100000001,272352118,2613322,2303325,309997,2495340,2206429,288911,37617,21454,16163,0,0,0,80365,75442,4923
630,ship++_leaders_32,config1,0.490921,100000000,203698711,373283,130429,242854,144394,55291,89103,71290,12205,59085,0,0,0,157599,62933,94666
631,ship++_leaders_32,config1,0.397866,100000001,251340691,2498537,1059173,1439364,2298578,859739,1438839,0,0,0,0,0,0,199959,199434,525
632,ship++_leaders_32,config1,0.45864,100000003,218036104,1769069,1450510,318559,1739414,1437220,302194,12908,2360,10548,0,0,0,16747,10930,5817
633,ship++_leaders_32,config1,0.54937,100000003,182026685,6027258,1593856,4433402,843450,155,843295,2591797,467025,2124772,0,0,0,2592011,1126676,1465335
634,ship++_leaders_32,config1,0.430135,100000003,232485173,1058895,132786,926109,632847,50326,582521,201034,794,200240,0,0,0,225014,81666,143348
635,ship++_leaders_32,config1,0.394448,100000000,253518761,411671,390279,21392,296216,280469,15747,32929,27649,5280,0,0,0,82526,82161,365
636,ship++_leaders_32,config1,0.733269,100000003,136375671,21200174,21146024,54150,194764,150658,44106,10471722,10461785,9937,0,0,0,10533688,10533581,107
637,ship++_leaders_32,config1,0.493699,100000000,202552394,3679365,1366212,2313153,2465980,853640,1612340,467657,176747,290910,0,0,0,745728,335825,409903
638,ship++_leaders_32,config1,0.829223,100000000,120594871,1432041,1205270,226771,1067515,937594,129921,180712,99898,80814,0,0,0,183814,167778,16036
639,ship++_leaders_32,config1,0.416299,100000003,240212160,1165596,365171,800425,633144,159745,473399,265372,74708,190664,0,0,0,267080,130718,136362
640,ship++_leaders_32,config1,0.38156,100000001,262081771,3801525,113429,3688096,2789401,97486,2691915,20,20,0,0,0,0,1012104,15923,996181
641,ship++_leaders_32,config1,0.431606,100000003,231692625,1105152,358102,747050,614443,178941,435502,245232,65589,179643,0,0,0,245477,113572,131905
642,ship++_leaders_32,config1,0.395922,100000003,252574992,405076,381471,23605,285435,267622,17813,34069,28779,5290,0,0,0,85572,85070,502
643,ship++_leaders_32,config1,0.433753,100000003,230545888,2675520,62633,2612887,1680645,10072,1670573,136848,9413,127435,0,0,0,858027,43148,814879
644,ship++_leaders_32,config1,0.500266,100000002,199893653,3572647,856907,2715740,2180495,506809,1673686,629127,118855,510272,0,0,0,763025,231243,531782
645,ship++_leaders_32,config1,0.235508,100000001,424614237,1984880,254912,1729968,1160902,103894,1057008,340263,37784,302479,0,0,0,483715,113234,370481
646,ship++_leaders_32,config1,0.614103,100000000,162839045,1575101,832097,743004,1332839,663656,669183,103774,66845,36929,0,0,0,138488,101596,36892
647,ship++_leaders_32,config1,0.126353,100000001,791435658,6966716,2703261,4263455,2413973,418645,1995328,1812774,629162,1183612,0,0,0,2739969,1655454,1084515
648,ship++_leaders_32,config1,0.746976,100000003,133873108,1134857,1002401,132456,519848,460738,59110,292434,223789,68645,0,0,0,322575,317874,4701
649,ship++_leaders_32,config1,0.1159,100000001,862813942,11193205,5166735,6026470,8987771,3679065,5308706,195607,130917,64690,0,0,0,2009827,1356753,653074
650,ship++_leaders_32,config1,1.02609,100000001,97457700,381989,15220,366769,315489,5549,309940,3447,1,3446,0,0,0,63053,9670,53383
651,ship++_leaders_32,config1,0.282905,100000003,353475144,7006987,3786408,3220579,4052500,1726478,2326022,856726,324989,531737,0,0,0,2097761,1734941,362820
652,ship++_leaders_32,config1,1.45086,100000003,68924633,1133161,1043230,89931,790337,729264,61073,47630,19636,27994,0,0,0,295194,294330,864
653,ship++_leaders_32,config1,0.439561,100000003,227499697,2838711,64279,2774432,1956031,10355,1945676,140009,0,140009,0,0,0,742671,53924,688747
654,ship++_leaders_32,config1,0.316477,100000000,315978377,2825481,2583969,241512,2094627,1859653,234974,16394,16026,368,0,0,0,714460,708290,6170
655,ship++_leaders_32,config1,0.084299,100000000,1186253846,14619444,7788763,6830681,14276846,7551756,6725090,25869,16693,9176,0,0,0,316729,220314,96415
656,ship++_leaders_32,config1,0.598156,100000000,167180567,1490753,465887,1024866,835382,196114,639268,219225,29881,189344,0,0,0,436146,239892,196254
657,ship++_leaders_32,config1,0.323147,100000003,309456624,5290128,2805143,2484985,3127281,1397150,1730131,652049,262426,389623,0,0,0,1510798,1145567,365231
658,ship++_leaders_32,config1,2.07426,100000001,48209981,1896,9,1887,1706,0,1706,181,0,181,0,0,0,9,9,0
659,ship++_leaders_32,config1,0.553203,100000000,180765523,119555,22716,96839,80540,3062,77478,1075,170,905,0,0,0,37940,19484,18456
660,ship++_leaders_32,config1,0.815522,100000002,122620852,991020,716545,274475,696690,508190,188500,102175,39715,62460,0,0,0,192155,168640,23515
661,ship++_leaders_32,config1,1.53637,100000003,65088490,827374,674809,152565,730855,579273,151582,414,392,22,0,0,0,96105,95144,961
662,ship++_leaders_32,config1,0.515905,100000003,193834240,2445955,82803,2363152,1321299,1761,1319538,423300,5447,417853,0,0,0,701356,75595,625761
663,ship++_leaders_32,config2,0.459592,100000000,217584327,1164263,335520,828743,22156,2187,19969,264086,67439,196647,611918,149497,462421,266103,116397,149706
664,ship++_leaders_32,config2,0.725199,100000001,137893178,42522,7324,35198,13577,393,13184,3352,12,3340,17694,476,17218,7899,6443,1456
665,ship++_leaders_32,config2,0.641576,100000001,155866172,5798349,1379393,4418956,418782,19940,398842,2473095,353221,2119874,433349,25957,407392,2473123,980275,1492848
666,ship++_leaders_32,config2,0.410545,100000000,243578735,157868,133371,24497,71023,61821,9202,11273,5617,5656,50719,41316,9403,24853,24617,236
667,ship++_leaders_32,config2,0.604908,100000003,165314367,5145102,249514,4895588,521152,109120,412032,18,0,18,3246631,55991,3190640,1377301,84403,1292898
668,ship++_leaders_32,config2,1.4215,100000003,70348296,831801,67353,764448,26480,12203,14277,201336,7906,193430,401180,14159,387021,202805,33085,169720
669,ship++_leaders_32,config2,0.673368,100000000,148507153,5489578,1459679,4029899,390473,14940,375533,2345816,401350,1944466,407144,19140,388004,2346145,1024249,1321896
670,ship++_leaders_32,config2,0.379722,100000000,263350649,8713335,4862060,3851275,2236512,1108079,1128433,764942,278491,486451,3551413,1640608,1910805,2160468,1834882,325586
671,ship++_leaders_32,config2,1.22629,100000003,81546803,1445897,857157,588740,118934,99658,19276,121984,120742,1242,1076585,508577,568008,128394,128180,214
672,ship++_leaders_32,config2,1.04857,100000000,95368313,1574040,826307,747733,202450,167699,34751,111347,109684,1663,1127086,418086,709000,133157,130838,2319
673,ship++_leaders_32,config2,0.109508,100000002,913177860,21078176,9698532,11379644,9505784,5891637,3614147,164311,55874,108437,9645168,2298583,7346585,1762913,1452438,310475
674,ship++_leaders_32,config2,1.35988,100000002,73536102,632006,295794,336212,37140,23896,13244,152071,75900,76171,286985,95353,191632,155810,100645,55165
675,ship++_leaders_32,config2,0.254515,100000000,392904222,4309276,1350438,2958838,1522632,442827,1079805,250415,85693,164722,1530196,189423,1340773,1006033,632495,373538
676,ship++_leaders_32,config2,0.637422,100000000,156881844,4600233,1100187,3500046,465906,127411,338495,742693,95110,647583,2291403,508925,1782478,1100231,368741,731490
677,ship++_leaders_32,config2,0.607417,100000001,164631605,4812688,559415,4253273,461704,34794,426910,126472,117188,9284,2860226,124980,2735246,1364286,282453,1081833
678,ship++_leaders_32,config2,0.554531,100000003,180332435,4917133,277308,4639825,1163170,42596,1120574,24,19,5,2227241,99833,2127408,1526698,134860,1391838
679,ship++_leaders_32,config2,0.483499,100000001,206825576,4047262,229209,3818053,834878,34392,800486,24,16,8,2171924,93387,2078537,1040436,101414,939022
680,ship++_leaders_32,config2,0.374165,100000001,267261750,4665744,2413836,2251908,2182741,2020675,162066,24961,11430,13531,2377673,317448,2060225,80369,64283,16086
681,ship++_leaders_32,config2,0.500111,100000001,199955734,479226,224918,254308,108310,60485,47825,72099,12820,59279,138957,60805,78152,159860,90808,69052
682,ship++_leaders_32,config2,0.446014,100000000,224208065,13008136,10697470,2310666,5288989,4385655,903334,0,0,0,6806449,5402428,1404021,912698,909387,3311
683,ship++_leaders_32,config2,0.46235,100000003,216286583,3283119,1533221,1749898,1562313,1390870,171443,5220,2632,2588,1698738,131745,1566993,16848,7974,8874
684,ship++_leaders_32,config2,0.62098,100000003,161035779,6074248,1516133,4558115,448375,21239,427136,2591736,383148,2208588,442172,25883,416289,2591965,1085863,1506102
685,ship++_leaders_32,config2,0.682564,100000000,146506382,1088964,144767,944197,57627,9621,48006,201537,1454,200083,601287,47871,553416,228513,85821,142692
686,ship++_leaders_32,config2,0.397528,100000000,251554542,656701,614325,42376,310902,302707,8195,30806,26530,4276,212713,183315,29398,102280,101773,507
687,ship++_leaders_32,config2,0.742081,100000003,134756147,21346127,21272614,73513,165896,131110,34786,10463422,10457724,5698,183321,150468,32853,10533488,10533312,176
688,ship++_leaders_32,config2,0.711617,100000000,140525057,3756958,1254880,2502078,404723,129310,275413,463745,173993,289752,2139277,602607,1536670,749213,348970,400243
689,ship++_leaders_32,config2,0.8958,100000000,111632047,2346599,2110244,236355,882486,861225,21261,180744,109313,71431,1098512,963721,134791,184857,175985,8872
690,ship++_leaders_32,config2,0.469824,100000003,212845830,1168825,333114,835711,25135,2406,22729,265309,77427,187882,611034,136995,474039,267347,116286,151061
691,ship++_leaders_32,config2,0.519649,100000000,192437619,3801551,130777,3670774,655851,36900,618951,20,20,0,2133575,77686,2055889,1012105,16171,995934
692,ship++_leaders_32,config2,0.484466,100000003,206412761,1107583,332549,775034,23114,3608,19506,245174,66975,178199,593786,158800,434986,245509,103166,142343
693,ship++_leaders_32,config2,0.398814,100000003,250743141,635547,575700,59847,295077,284295,10782,30364,25796,4568,206826,163565,43261,103280,102044,1236
694,ship++_leaders_32,config2,0.580388,100000003,172298613,3300884,83294,3217590,970576,170,970406,136847,14929,121918,1335372,9906,1325466,858089,58289,799800
695,ship++_leaders_32,config2,0.729566,100000001,137067845,3583296,759149,2824147,296822,57398,239424,622466,117528,504938,1900637,334207,1566430,763371,250016,513355
696,ship++_leaders_32,config2,0.26301,100000001,380214320,2541238,335668,2205570,647323,64084,583239,278001,35097,242904,1132214,79795,1052419,483700,156692,327008
697,ship++_leaders_32,config2,0.874924,100000000,114295630,1795717,730876,1064841,315455,176573,138882,99632,78914,20718,1239210,344239,894971,141420,131150,10270
698,ship++_leaders_32,config2,0.138976,100000001,719550309,8752168,2735262,6016906,1888015,514344,1373671,1828655,427899,1400756,2272666,176694,2095972,2762832,1616325,1146507
699,ship++_leaders_32,config2,0.769756,100000003,129911326,1571205,1426264,144941,429756,406629,23127,294157,233221,60936,521321,467428,53893,325971,318986,6985
700,ship++_leaders_32,config2,0.121106,100000001,825724212,18751201,8228480,10522721,8468439,4395420,4073019,206376,69217,137159,7968952,2082359,5886593,2107434,1681484,425950
701,ship++_leaders_32,config2,1.29367,100000001,77299608,382567,18814,363753,27962,522,27440,3434,3,3431,287937,3673,284264,63234,14616,48618
702,ship++_leaders_32,config2,0.364151,100000003,274611686,8729349,4614159,4115190,2230154,1045808,1184346,871491,307213,564278,3452793,1502884,1949909,2174911,1758254,416657
703,ship++_leaders_32,config2,1.79696,100000000,55649649,1161473,1008717,152756,133690,127616,6074,47550,19936,27614,680415,562523,117892,299818,298642,1176
704,ship++_leaders_32,config2,0.557476,100000003,179379850,3481386,61805,3419581,1002064,44,1002020,140009,0,140009,1596642,9863,1586779,742671,51898,690773
705,ship++_leaders_32,config2,0.339613,100000000,294453187,5227611,4925174,302437,2121364,1999114,122250,29854,29577,277,2267223,2096492,170731,809170,799991,9179
706,ship++_leaders_32,config2,0.123887,100000000,807188107,26952773,13429057,13523716,11715171,9875856,1839315,27346,10832,16514,14876573,3271625,11604948,333683,270744,62939
707,ship++_leaders_32,config2,0.787621,100000000,126964547,1495380,533053,962327,89824,28458,61366,219210,37894,181316,750197,176222,573975,436149,290479,145670
708,ship++_leaders_32,config2,0.405064,100000003,246874344,6596676,3338812,3257864,1694995,769227,925768,658477,255827,402650,2682566,1114043,1568523,1560638,1199715,360923
709,ship++_leaders_32,config2,2.07905,100000001,48098913,2155,25,2130,803,0,803,129,0,129,1200,2,1198,23,23,0
710,ship++_leaders_32,config2,0.565135,100000002,176948906,134715,36533,98182,14854,4249,10605,1238,334,904,79526,9884,69642,39097,22066,17031
711,ship++_leaders_32,config2,0.914306,100000002,109372588,1373537,1055145,318392,396218,348690,47528,104383,39887,64496,675954,503534,172420,196982,163034,33948
712,ship++_leaders_32,config2,1.97504,100000000,50631878,865128,583410,281718,110516,92739,17777,417,404,13,655884,399153,256731,98311,91114,7197
713,ship++_leaders_32,config2,0.678313,100000003,147424587,2872436,81505,2790931,739086,74,739012,423298,7966,415332,1009334,1745,1007589,700718,71720,628998
714,lime,config1,0.406215,100000000,246174930,1162160,333138,829022,632029,137126,494903,264148,60558,203590,0,0,0,265983,135454,130529
715,lime,config1,0.723626,100000001,138192879,32513,7940,24573,21583,407,21176,3395,1,3394,0,0,0,7535,7532,3
716,lime,config1,0.590233,100000001,169424560,5752321,1616552,4135769,806178,24,806154,2473069,528968,1944101,0,0,0,2473074,1087560,1385514
717,lime,config1,0.40945,100000000,244229898,81693,61815,19878,53416,39660,13756,10648,4526,6122,0,0,0,17629,17629,0
718,lime,config1,0.346602,100000003,288515500,4687839,796537,3891302,3310967,666305,2644662,20,0,20,0,0,0,1376852,130232,1246620
719,lime,config1,1.1392,100000003,87781077,789842,173748,616094,401374,91242,310132,194168,902,193266,0,0,0,194300,81604,112696
720,lime,config1,0.60721,100000000,164687615,5455658,1560677,3894981,763532,94,763438,2345906,504774,1841132,0,0,0,2346220,1055809,1290411
721,lime,config1,0.287819,100000000,347441049,6993503,3833323,3160180,4167419,1818649,2348770,751801,302750,449051,0,0,0,2074283,1711924,362359
722,lime,config1,0.917485,100000002,108993662,1399109,1072892,326217,1148252,844906,303346,122689,107045,15644,0,0,0,128168,120941,7227
723,lime,config1,0.728239,100000002,137317640,1449232,895991,553241,1202431,704029,498402,114009,82007,32002,0,0,0,132792,109955,22837
724,lime,config1,0.0892473,100000002,1120481897,12168030,5542446,6625584,10389061,4400751,5988310,150397,83247,67150,0,0,0,1628572,1058448,570124
725,lime,config1,1.07955,100000002,92631416,613116,298166,314950,304680,110269,194411,151946,74967,76979,0,0,0,156490,112930,43560
726,lime,config1,0.234297,100000000,426808194,3244341,1408071,1836270,1933257,486396,1446861,328079,81559,246520,0,0,0,983005,840116,142889
727,lime,config1,0.459356,100000000,217695879,4478003,1460245,3017758,2621196,679161,1942035,760438,90951,669487,0,0,0,1096369,690133,406236
728,lime,config1,0.369261,100000001,270811042,4564551,1203510,3361041,3073733,636591,2437142,126461,114402,12059,0,0,0,1364357,452517,911840
729,lime,config1,0.460606,100000001,217105346,4917103,472110,4444993,3390381,159090,3231291,24,16,8,0,0,0,1526698,313004,1213694
730,lime,config1,0.356365,100000003,280611519,4047234,310729,3736505,3006773,155606,2851167,24,16,8,0,0,0,1040437,155107,885330
731,lime,config1,0.361521,100000001,276609412,2613318,2169075,444243,2495337,2082290,413047,37616,21570,16046,0,0,0,80365,65215,15150
732,lime,config1,0.496409,100000000,201446675,373291,269208,104083,144399,73413,70986,71290,40766,30524,0,0,0,157602,155029,2573
733,lime,config1,0.396822,100000001,252001974,2495433,1040099,1455334,2296043,841403,1454640,0,0,0,0,0,0,199390,198696,694
734,lime,config1,0.444646,100000003,224898091,1769069,1281117,487952,1739414,1271924,467490,12908,2402,10506,0,0,0,16747,6791,9956
735,lime,config1,0.570955,100000003,175145016,6027275,1698868,4328407,843451,132,843319,2591805,550913,2040892,0,0,0,2592019,1147823,1444196
736,lime,config1,0.43292,100000003,230989518,1058894,270970,787924,632847,48210,584637,201034,794,200240,0,0,0,225013,221966,3047
737,lime,config1,0.3945,100000000,253485121,411672,390297,21375,296217,280622,15595,32929,27711,5218,0,0,0,82526,81964,562
738,lime,config1,0.730903,100000003,136817126,21200174,21111923,88251,194764,144499,50265,10471722,10461001,10721,0,0,0,10533688,10506423,27265
739,lime,config1,0.497053,100000000,201185685,3679358,1465126,2214232,2465980,861853,1604127,467657,173229,294428,0,0,0,745721,430044,315677
740,lime,config1,0.820139,100000000,121930623,1432051,1185667,246384,1067511,916808,150703,180722,105565,75157,0,0,0,183818,163294,20524
741,lime,config1,0.414551,100000003,241224768,1165598,334268,831330,633144,142327,490817,265372,55524,209848,0,0,0,267082,136417,130665
742,lime,config1,0.402998,100000001,248139948,3801525,338488,3463037,2789401,155574,2633827,20,15,5,0,0,0,1012104,182899,829205
743,lime,config1,0.428965,100000003,233119470,1105150,325668,779482,614443,155495,458948,245232,54960,190272,0,0,0,245475,115213,130262
744,lime,config1,0.395911,100000003,252582106,405076,381562,23514,285435,267524,17911,34069,29112,4957,0,0,0,85572,84926,646
745,lime,config1,0.431719,100000003,231632292,2675520,259815,2415705,1680645,15973,1664672,136848,0,136848,0,0,0,858027,243842,614185
746,lime,config1,0.501829,100000002,199271168,3572665,1101164,2471501,2180510,487082,1693428,629124,111284,517840,0,0,0,763031,502798,260233
747,lime,config1,0.231789,100000001,431426112,1984398,259341,1725057,1160250,46924,1113326,340915,10003,330912,0,0,0,483233,202414,280819
748,lime,config1,0.589183,100000000,169726428,1575111,737631,837480,1332848,542335,790513,103773,69004,34769,0,0,0,138490,126292,12198
749,lime,config1,0.129821,100000001,770292788,6966703,2562177,4404526,2413965,546391,1867574,1812772,705140,1107632,0,0,0,2739966,1310646,1429320
750,lime,config1,0.746114,100000003,134027810,1134870,991802,143068,519852,458366,61486,292435,225765,66670,0,0,0,322583,307671,14912
751,lime,config1,0.113381,100000001,881984492,11193237,4831440,6361797,8987736,3476022,5511714,195625,114471,81154,0,0,0,2009876,1240947,768929
752,lime,config1,1.02515,100000001,97546929,381989,52006,329983,315489,2873,312616,3447,1,3446,0,0,0,63053,49132,13921
753,lime,config1,0.284043,100000003,352058988,7007010,3740410,3266600,4052506,1717978,2334528,856730,334193,522537,0,0,0,2097774,1688239,409535
754,lime,config1,1.46844,100000003,68099296,1133161,1030513,102648,790337,732730,57607,47630,14790,32840,0,0,0,295194,282993,12201
755,lime,config1,0.440429,100000003,227051238,2838711,280733,2557978,1956031,14340,1941691,140009,0,140009,0,0,0,742671,266393,476278
756,lime,config1,0.311958,100000000,320556435,2825471,2509757,315714,2094613,1826870,267743,16394,16015,379,0,0,0,714464,666872,47592
757,lime,config1,0.0837042,100000000,1194682493,14619470,7734471,6884999,14276872,7473088,6803784,25874,15661,10213,0,0,0,316724,245722,71002
758,lime,config1,0.581209,100000000,172055020,1490754,448098,1042656,835383,126201,709182,219225,15995,203230,0,0,0,436146,305902,130244
759,lime,config1,0.323188,100000002,309416975,5290136,2687891,2602245,3127269,1368888,1758381,652054,257100,394954,0,0,0,1510813,1061903,448910
760,lime,config1,2.07426,100000001,48209981,1896,9,1887,1706,0,1706,181,0,181,0,0,0,9,9,0
761,lime,config1,0.553295,100000000,180735293,119554,41627,77927,80540,3572,76968,1075,168,907,0,0,0,37939,37887,52
762,lime,config1,0.809725,100000002,123498727,991023,696721,294302,696691,496354,200337,102176,48756,53420,0,0,0,192156,151611,40545
763,lime,config1,1.55528,100000003,64297169,827374,690577,136797,730855,594530,136325,414,406,8,0,0,0,96105,95641,464
764,lime,config1,0.514375,100000003,194410799,2445955,254782,2191173,1321299,1770,1319529,423300,0,423300,0,0,0,701356,253012,448344
765,lime,config2,0.458671,100000000,218021107,1166852,332591,834261,25196,1837,23359,264086,13484,250602,611464,150237,461227,266106,167033,99073
766,lime,config2,0.725215,100000001,137890098,42518,7494,35024,13577,250,13327,3350,10,3340,17694,221,17473,7897,7013,884
767,lime,config2,0.686695,100000001,145625127,5792204,1607660,4184544,415587,13,415574,2473096,522871,1950225,430399,4,430395,2473122,1084772,1388350
768,lime,config2,0.409684,100000000,244090802,157833,98955,58878,70991,60979,10012,11273,5472,5801,50722,9852,40870,24847,22652,2195
769,lime,config2,0.602573,100000000,165955135,5145135,172194,4972941,521910,110450,411460,18,0,18,3245910,10352,3235558,1377297,51392,1325905
770,lime,config2,1.4116,100000003,70841620,833130,145928,687202,26326,10192,16134,201616,8282,193334,401999,3016,398983,203189,124438,78751
771,lime,config2,0.710737,100000000,140699022,5490724,1551721,3939003,390888,63,390825,2345817,502258,1843559,407878,6,407872,2346141,1049394,1296747
772,lime,config2,0.367387,100000000,272192223,8716800,4207460,4509340,2239388,973143,1266245,764923,329104,435819,3551973,1353469,2198504,2160516,1551744,608772
773,lime,config2,1.16068,100000003,86156415,1445979,464034,981945,119000,99960,19040,121981,120916,1065,1076604,114900,961704,128394,128258,136
774,lime,config2,1.02258,100000002,97791804,1574049,544038,1030011,202279,170833,31446,111381,109799,1582,1127230,131114,996116,133159,132292,867
775,lime,config2,0.101301,100000002,987156479,21080361,8370915,12709446,9507911,5171363,4336548,164421,95061,69360,9645264,1982033,7663231,1762765,1122458,640307
776,lime,config2,1.34111,100000002,74564941,631640,303881,327759,35117,7658,27459,152070,75777,76293,288653,72386,216267,155800,148060,7740
777,lime,config2,0.254535,100000000,392872964,4309218,1385227,2923991,1524088,446432,1077656,249588,83338,166250,1529531,148409,1381122,1006011,707048,298963
778,lime,config2,0.614647,100000000,162695124,4606804,959368,3647436,464231,58625,405606,743236,94379,648857,2299511,151068,2148443,1099826,655296,444530
779,lime,config2,0.608786,100000001,164261276,4812548,579868,4232680,462073,36264,425809,126471,96745,29726,2859714,108115,2751599,1364290,338744,1025546
780,lime,config2,0.560567,100000001,178390662,4917136,303535,4613601,1156732,32238,1124494,24,17,7,2233681,86823,2146858,1526699,184457,1342242
781,lime,config2,0.495204,100000001,201937088,4047262,193365,3853897,834773,22516,812257,24,6,18,2172029,85176,2086853,1040436,85667,954769
782,lime,config2,0.372431,100000001,268505909,4666938,2204358,2462580,2187226,1993956,193270,24959,10666,14293,2374384,167933,2206451,80369,31803,48566
783,lime,config2,0.500755,100000001,199698567,479215,286437,192778,108316,62644,45672,72100,39722,32378,138936,47195,91741,159863,136876,22987
784,lime,config2,0.344737,100000000,290076379,12928445,5941705,6986740,5281737,3819910,1461827,0,0,0,6739267,1417967,5321300,907441,703828,203613
785,lime,config2,0.455381,100000003,219596183,3282799,1307702,1975097,1563273,1235242,328031,5220,2345,2875,1697458,64503,1632955,16848,5612,11236
786,lime,config2,0.66287,100000003,150859140,6070127,1692811,4377316,445860,95,445765,2591767,544591,2047176,440505,1,440504,2591995,1148124,1443871
787,lime,config2,0.681322,100000000,146773524,1085932,248332,837600,57086,8516,48570,201474,1282,200192,599248,10747,588501,228124,227787,337
788,lime,config2,0.395657,100000000,252743919,656656,485451,171205,310860,303398,7462,30799,27024,3775,212722,58078,154644,102275,96951,5324
789,lime,config2,0.73087,100000003,136823283,21346119,21107260,238859,165909,121024,44885,10463422,10456832,6590,183300,26399,156901,10533488,10503005,30483
790,lime,config2,0.682833,100000000,146448718,3758472,921173,2837299,402897,79754,323143,463723,173996,289727,2142709,219824,1922885,749143,447599,301544
791,lime,config2,0.886351,100000000,112822100,2346770,2034058,312712,882451,845685,36766,180754,113070,67684,1098703,910754,187949,184862,164549,20313
792,lime,config2,0.468381,100000003,213501417,1173954,344317,829637,30287,1888,28399,265309,13632,251677,611013,148704,462309,267345,180093,87252
793,lime,config2,0.531788,100000000,188044835,3801551,104635,3696916,657129,6361,650768,20,15,5,2132297,32450,2099847,1012105,65809,946296
794,lime,config2,0.482851,100000003,207103369,1111827,315059,796768,27381,2475,24906,245174,17979,227195,593762,165513,428249,245510,129092,116418
795,lime,config2,0.397764,100000003,251405308,635526,466933,168593,295069,287180,7889,30362,27053,3309,206814,54743,152071,103281,97957,5324
796,lime,config2,0.579583,100000003,172537807,3300884,177222,3123662,973198,1878,971320,136847,4,136843,1332750,24060,1308690,858089,151280,706809
797,lime,config2,0.706761,100000001,141490614,3584067,810263,2773804,298968,43298,255670,622457,117253,505204,1899456,131492,1767964,763186,518220,244966
798,lime,config2,0.26411,100000001,378630797,2540814,289472,2251342,647877,67109,580768,277473,28410,249063,1132247,64287,1067960,483217,129666,353551
799,lime,config2,0.89505,100000000,111725658,1795867,625749,1170118,314434,270033,44401,99579,87851,11728,1240440,138482,1101958,141414,129383,12031
800,lime,config2,0.144394,100000001,692551166,8750851,3029308,5721543,1885651,633025,1252626,1828604,775668,1052936,2273825,68900,2204925,2762771,1551715,1211056
801,lime,config2,0.762522,100000003,131143704,1570560,1372562,197998,429853,395842,34011,294158,238603,55555,520580,436990,83590,325969,301127,24842
802,lime,config2,0.118661,100000001,842740166,18783898,7380865,11403033,8477764,3950970,4526794,206418,126098,80320,7991633,1947616,6044017,2108083,1356181,751902
803,lime,config2,1.29916,100000001,76972559,382563,16110,366453,28065,409,27656,3434,0,3434,287830,4430,283400,63234,11271,51963
804,lime,config2,0.355631,100000003,281190471,8735123,4033383,4701740,2233696,944043,1289653,871505,364371,507134,3455015,1227548,2227467,2174907,1497421,677486
805,lime,config2,1.75928,100000000,56841341,1161480,905193,256287,133728,128464,5264,47550,19725,27825,680383,463125,217258,299819,293879,5940
806,lime,config2,0.560719,100000003,178342327,3481387,207415,3273972,1002081,6,1002075,140009,0,140009,1596626,25852,1570774,742671,181557,561114
807,lime,config2,0.324319,100000000,308338779,5223282,3779526,1443756,2121322,1926276,195046,29853,29509,344,2262948,1105558,1157390,809159,718183,90976
808,lime,config2,0.108157,100000000,924578480,26976876,11375104,15601772,11727973,8668734,3059239,27340,16395,10945,14887837,2413129,12474708,333726,276846,56880
809,lime,config2,0.789394,100000000,126679516,1495352,505128,990224,90530,30933,59597,219210,51959,167251,749468,160136,589332,436144,262100,174044
810,lime,config2,0.404487,100000003,247226464,6600756,3078800,3521956,1697449,782639,914810,658489,305494,352995,2684178,926547,1757631,1560640,1064120,496520
811,lime,config2,2.07905,100000001,48098913,2155,10,2145,803,0,803,129,0,129,1200,0,1200,23,10,13
812,lime,config2,0.564937,100000002,177010748,134671,17877,116794,14781,3903,10878,1240,335,905,79544,6312,73232,39106,7327,31779
813,lime,config2,0.91007,100000002,109881608,1373502,997494,376008,396200,340241,55959,104382,37789,66593,675939,483822,192117,196981,135642,61339
814,lime,config2,1.74076,100000000,57446030,865134,194670,670464,110528,89574,20954,413,407,6,655881,48945,606936,98312,55744,42568
815,lime,config2,0.679384,100000003,147192223,2872436,261982,2610454,739370,642,738728,423298,0,423298,1009050,1050,1008000,700718,260290,440428
816,ship++,config1,0.407415,100000000,245449720,1162156,362187,799969,632027,155728,476299,264148,78025,186123,0,0,0,265981,128434,137547
817,ship++,config1,0.723638,100000001,138190642,32513,7872,24641,21583,407,21176,3395,1,3394,0,0,0,7535,7464,71
818,ship++,config1,0.557539,100000001,179359547,5752331,1462598,4289733,806178,39,806139,2473072,381244,2091828,0,0,0,2473081,1081315,1391766
819,ship++,config1,0.40945,100000000,244230268,81693,61811,19882,53416,39658,13758,10648,4526,6122,0,0,0,17629,17627,2
820,ship++,config1,0.347393,100000003,287858374,4687854,808397,3879457,3310981,704445,2606536,20,0,20,0,0,0,1376853,103952,1272901
821,ship++,config1,1.13967,100000003,87744962,789892,120873,669019,401403,95369,306034,194182,906,193276,0,0,0,194307,24598,169709
822,ship++,config1,0.578352,100000000,172905088,5455666,1383869,4071797,763535,151,763384,2345909,381536,1964373,0,0,0,2346222,1002182,1344040
823,ship++,config1,0.286746,100000000,348741003,6993623,3864795,3128828,4167496,1826074,2341422,751803,299023,452780,0,0,0,2074324,1739698,334626
824,ship++,config1,0.909127,100000002,109995615,1399110,1059509,339601,1148253,812861,335392,122689,118840,3849,0,0,0,128168,127808,360
825,ship++,config1,0.757624,100000002,131991579,1449280,998565,450715,1202474,763634,438840,114014,105621,8393,0,0,0,132792,129310,3482
826,ship++,config1,0.092377,100000002,1082521144,12167943,5942250,6225693,10389074,4743298,5645776,150272,89356,60916,0,0,0,1628597,1109596,519001
827,ship++,config1,1.08306,100000002,92331006,613107,286843,326264,304677,113541,191136,151947,75540,76407,0,0,0,156483,97762,58721
828,ship++,config1,0.235264,100000000,425053763,3244349,1276334,1968015,1932956,508374,1424582,328389,92648,235741,0,0,0,983004,675312,307692
829,ship++,config1,0.46426,100000000,215396564,4478789,1157732,3321057,2621613,725426,1896187,760114,100968,659146,0,0,0,1097062,331338,765724
830,ship++,config1,0.369725,100000001,270471596,4564553,1033332,3531221,3073733,650353,2423380,126461,111587,14874,0,0,0,1364359,271392,1092967
831,ship++,config1,0.44501,100000001,224713841,4917103,206960,4710143,3390381,129836,3260545,24,24,0,0,0,0,1526698,77100,1449598
832,ship++,config1,0.347127,100000003,288079330,4047234,256747,3790487,3006773,159025,2847748,24,18,6,0,0,0,1040437,97704,942733
833,ship++,config1,0.368753,100000001,271183892,2613322,2333482,279840,2495344,2235669,259675,37613,21764,15849,0,0,0,80365,76049,4316
834,ship++,config1,0.491518,100000000,203451296,373285,146976,226309,144395,57603,86792,71290,16905,54385,0,0,0,157600,72468,85132
835,ship++,config1,0.397481,100000001,251584589,2498820,1057028,1441792,2298937,857993,1440944,0,0,0,0,0,0,199883,199035,848
836,ship++,config1,0.458131,100000003,218278401,1769070,1357519,411551,1739415,1343553,395862,12908,2664,10244,0,0,0,16747,11302,5445
837,ship++,config1,0.544395,100000003,183690124,6027266,1615754,4411512,843448,150,843298,2591806,443246,2148560,0,0,0,2592012,1172358,1419654
838,ship++,config1,0.429668,100000003,232737604,1058894,130346,928548,632847,48773,584074,201034,793,200241,0,0,0,225013,80780,144233
839,ship++,config1,0.394449,100000000,253517999,411671,390197,21474,296216,280393,15823,32929,27656,5273,0,0,0,82526,82148,378
840,ship++,config1,0.733338,100000003,136362726,21200174,21146043,54131,194764,150674,44090,10471722,10461785,9937,0,0,0,10533688,10533584,104
841,ship++,config1,0.49579,100000000,201698432,3679381,1371664,2307717,2465992,860899,1605093,467655,176417,291238,0,0,0,745734,334348,411386
842,ship++,config1,0.829212,100000000,120596475,1432051,1204523,227528,1067513,938421,129092,180719,99944,80775,0,0,0,183819,166158,17661
843,ship++,config1,0.41499,100000003,240969646,1165598,359497,806101,633144,156006,477138,265372,74669,190703,0,0,0,267082,128822,138260
844,ship++,config1,0.381479,100000001,262137841,3801525,111793,3689732,2789401,95850,2693551,20,20,0,0,0,0,1012104,15923,996181
845,ship++,config1,0.426708,100000003,234352267,1105151,340409,764742,614443,159242,455201,245232,68109,177123,0,0,0,245476,113058,132418
846,ship++,config1,0.395905,100000003,252585594,405075,381489,23586,285435,267547,17888,34069,28822,5247,0,0,0,85571,85120,451
847,ship++,config1,0.433609,100000003,230622283,2675520,63279,2612241,1680645,8754,1671891,136848,10729,126119,0,0,0,858027,43796,814231
848,ship++,config1,0.500905,100000002,199638529,3572660,848567,2724093,2180509,510345,1670164,629125,119411,509714,0,0,0,763026,218811,544215
849,ship++,config1,0.235663,100000001,424335451,1984662,257900,1726762,1160896,107602,1053294,340270,37853,302417,0,0,0,483496,112445,371051
850,ship++,config1,0.614987,100000000,162605059,1575107,834585,740522,1332843,648551,684292,103774,73893,29881,0,0,0,138490,112141,26349
851,ship++,config1,0.12781,100000001,782412594,6966704,2674483,4292221,2413967,482466,1931501,1812772,675678,1137094,0,0,0,2739965,1516339,1223626
852,ship++,config1,0.747117,100000003,133847796,1134878,1001457,133421,519856,461325,58531,292438,222957,69481,0,0,0,322584,317175,5409
853,ship++,config1,0.115683,100000001,864430808,11193221,5134951,6058270,8987785,3670946,5316839,195607,126044,69563,0,0,0,2009829,1337961,671868
854,ship++,config1,1.02647,100000001,97421494,381990,15290,366700,315489,5749,309740,3447,1,3446,0,0,0,63054,9540,53514
855,ship++,config1,0.282747,100000003,353672842,7006976,3690620,3316356,4052503,1707870,2344633,856729,324584,532145,0,0,0,2097744,1658166,439578
856,ship++,config1,1.46183,100000003,68407436,1133161,1046027,87134,790337,732979,57358,47630,19429,28201,0,0,0,295194,293619,1575
857,ship++,config1,0.439855,100000003,227347387,2838711,65423,2773288,1956031,11744,1944287,140009,0,140009,0,0,0,742671,53679,688992
858,ship++,config1,0.316511,100000000,315944818,2825481,2583118,242363,2094627,1859958,234669,16394,16020,374,0,0,0,714460,707140,7320
859,ship++,config1,0.0842952,100000000,1186307554,14619471,7792914,6826557,14276868,7552369,6724499,25870,16683,9187,0,0,0,316733,223862,92871
860,ship++,config1,0.59763,100000000,167327488,1490751,453850,1036901,835382,193605,641777,219225,29373,189852,0,0,0,436144,230872,205272
861,ship++,config1,0.323206,100000002,309400123,5290170,2802245,2487925,3127302,1397329,1729973,652046,259667,392379,0,0,0,1510822,1145249,365573
862,ship++,config1,2.07426,100000001,48209981,1896,9,1887,1706,0,1706,181,0,181,0,0,0,9,9,0
863,ship++,config1,0.553272,100000000,180743000,119555,22851,96704,80540,2977,77563,1075,170,905,0,0,0,37940,19704,18236
864,ship++,config1,0.814798,100000002,122729803,991026,711536,279490,696694,506376,190318,102176,39429,62747,0,0,0,192156,165731,26425
865,ship++,config1,1.48839,100000003,67186477,827374,635569,191805,730855,539655,191200,414,393,21,0,0,0,96105,95521,584
866,ship++,config1,0.516238,100000003,193708972,2445955,76093,2369862,1321299,2008,1319291,423300,6190,417110,0,0,0,701356,67895,633461
867,ship++,config2,0.459738,100000000,217515381,1164143,328708,835435,21813,2230,19583,264086,77223,186863,612139,133932,478207,266105,115323,150782
868,ship++,config2,0.725208,100000001,137891538,42522,7078,35444,13577,394,13183,3352,12,3340,17694,474,17220,7899,6198,1701
869,ship++,config2,0.644475,100000001,155164956,5795689,1429996,4365693,417620,18769,398851,2473085,379327,2093758,431879,24500,407379,2473105,1007400,1465705
870,ship++,config2,0.410569,100000000,243564378,157868,133925,23943,71023,61828,9195,11273,5616,5657,50719,41858,8861,24853,24623,230
871,ship++,config2,0.605996,100000003,165017696,5145129,259559,4885570,521271,123418,397853,18,0,18,3246547,55688,3190859,1377293,80453,1296840
872,ship++,config2,1.42593,100000003,70129580,831574,81450,750124,26104,12387,13717,201312,7867,193445,401372,27623,373749,202786,33573,169213
873,ship++,config2,0.666024,100000000,150144710,5492423,1423446,4068977,391711,16147,375564,2345791,367579,1978212,408804,20837,387967,2346117,1018883,1327234
874,ship++,config2,0.380156,100000000,263049882,8713207,4834714,3878493,2236195,1108237,1127958,764923,279289,485634,3551620,1644796,1906824,2160469,1802392,358077
875,ship++,config2,1.22611,100000003,81559083,1445925,852474,593451,118929,100152,18777,121987,120565,1422,1076613,503569,573044,128396,128188,208
876,ship++,config2,1.0509,100000000,95156247,1574050,845585,728465,202239,167805,34434,111350,109678,1672,1127305,437455,689850,133156,130647,2509
877,ship++,config2,0.109471,100000002,913487103,21078336,9739059,11339277,9505605,5900037,3605568,164364,54327,110037,9645416,2294901,7350515,1762951,1489794,273157
878,ship++,config2,1.3594,100000002,73562073,631944,293183,338761,37118,23559,13559,152071,75869,76202,286948,94518,192430,155807,99237,56570
879,ship++,config2,0.254535,100000000,392873845,4309315,1381227,2928088,1523184,448690,1074494,250330,90964,159366,1529764,181507,1348257,1006037,660066,345971
880,ship++,config2,0.638917,100000000,156514954,4600420,1102936,3497484,466321,132181,334140,742543,96559,645984,2291204,520121,1771083,1100352,354075,746277
881,ship++,config2,0.608998,100000000,164204084,4812831,572426,4240405,461872,41233,420639,126472,117199,9273,2860192,140622,2719570,1364295,273372,1090923
882,ship++,config2,0.556147,100000003,179808447,4917133,277801,4639332,1164870,56105,1108765,24,24,0,2225541,96008,2129533,1526698,125664,1401034
883,ship++,config2,0.483547,100000001,206805149,4047262,232877,3814385,834918,38403,796515,24,14,10,2171884,97375,2074509,1040436,97085,943351
884,ship++,config2,0.375,100000001,266666454,4665097,2426296,2238801,2183334,2036634,146700,24960,12127,12833,2376434,314172,2062262,80369,63363,17006
885,ship++,config2,0.499571,100000001,200171871,479224,273344,205880,108311,59367,48944,72099,33509,38590,138954,56632,82322,159860,123836,36024
886,ship++,config2,0.446024,100000000,224203226,13010450,10700616,2309834,5289809,4386875,902934,0,0,0,6807370,5404137,1403233,913271,909604,3667
887,ship++,config2,0.462523,100000003,216205526,3283115,1541325,1741790,1562809,1361130,201679,5220,2741,2479,1698238,169091,1529147,16848,8363,8485
888,ship++,config2,0.616574,100000003,162186465,6074193,1520322,4553871,448317,21137,427180,2591719,358290,2233429,442215,25973,416242,2591942,1114922,1477020
889,ship++,config2,0.682236,100000000,146576829,1089043,142070,946973,57702,8763,48939,201523,1450,200073,601299,48455,552844,228519,83402,145117
890,ship++,config2,0.397483,100000000,251582829,656700,613021,43679,310902,302790,8112,30806,26524,4282,212712,182047,30665,102280,101660,620
891,ship++,config2,0.742163,100000003,134741244,21346126,21272534,73592,165897,131122,34775,10463422,10457724,5698,183319,150375,32944,10533488,10533313,175
892,ship++,config2,0.708181,100000000,141206912,3757675,1204734,2552941,404256,120263,283993,463735,173968,289767,2140512,576927,1563585,749172,333576,415596
893,ship++,config2,0.897025,100000000,111479670,2346441,2092979,253462,882464,863221,19243,180703,105406,75297,1098454,957184,141270,184820,167168,17652
894,ship++,config2,0.469863,100000003,212827933,1168912,336200,832712,25434,2619,22815,265309,76022,189287,610823,140906,469917,267346,116653,150693
895,ship++,config2,0.520073,100000000,192280838,3801551,128689,3672862,656085,37733,618352,20,20,0,2133341,74777,2058564,1012105,16159,995946
896,ship++,config2,0.48448,100000003,206406980,1107570,333504,774066,23189,3655,19534,245174,65959,179215,593697,160809,432888,245510,103081,142429
897,ship++,config2,0.399014,100000003,250617986,635548,577296,58252,295071,285191,9880,30364,25996,4368,206830,164086,42744,103283,102023,1260
898,ship++,config2,0.580286,100000003,172328889,3300884,85178,3215706,970637,247,970390,136847,15324,121523,1335311,10425,1324886,858089,59182,798907
899,ship++,config2,0.725108,100000001,137910431,3583103,723904,2859199,296033,52400,243633,622472,116543,505929,1901182,312635,1588547,763416,242326,521090
900,ship++,config2,0.263637,100000001,379309646,2541250,354548,2186702,647366,67150,580216,278136,37328,240808,1132099,90844,1041255,483649,159226,324423
901,ship++,config2,0.87655,100000000,114083620,1795726,719361,1076365,315537,203342,112195,99618,76610,23008,1239151,312440,926711,141420,126969,14451
902,ship++,config2,0.137706,100000001,726185777,8753188,2592851,6160337,1888752,476887,1411865,1828652,392063,1436589,2272949,186432,2086517,2762835,1537469,1225366
903,ship++,config2,0.770129,100000003,129848415,1571350,1425696,145654,429701,407154,22547,294157,234215,59942,521520,465930,55590,325972,318397,7575
904,ship++,config2,0.121114,100000001,825666909,18753873,8245361,10508512,8469215,4418327,4050888,206411,69636,136775,7970737,2096962,5873775,2107510,1660436,447074
905,ship++,config2,1.29397,100000001,77281723,382567,18343,364224,27952,435,27517,3434,3,3431,287945,4522,283423,63236,13383,49853
906,ship++,config2,0.364942,100000003,274016442,8729980,4579977,4150003,2230332,1046078,1184254,871525,313872,557653,3453182,1500826,1952356,2174941,1719201,455740
907,ship++,config2,1.81126,100000000,55210162,1161496,1042479,119017,133703,127372,6331,47550,19676,27874,680419,597536,82883,299824,297895,1929
908,ship++,config2,0.557498,100000003,179372842,3481389,61679,3419710,1002050,47,1002003,140009,0,140009,1596659,9770,1586889,742671,51862,690809
909,ship++,config2,0.339605,100000000,294459385,5227568,4923231,304337,2121357,1999001,122356,29853,29575,278,2267189,2096483,170706,809169,798172,10997
910,ship++,config2,0.123508,100000000,809664665,26953129,13364842,13588287,11715486,9849852,1865634,27352,10744,16608,14876576,3239101,11637475,333715,265145,68570
911,ship++,config2,0.781237,100000000,128002049,1495355,459208,1036147,89292,24842,64450,219210,35964,183246,750709,155929,594780,436144,242473,193671
912,ship++,config2,0.404137,100000003,247440895,6595598,3294400,3301198,1694362,772505,921857,658485,239228,419257,2682107,1101600,1580507,1560644,1181067,379577
913,ship++,config2,2.07905,100000001,48098913,2155,25,2130,803,0,803,129,0,129,1200,2,1198,23,23,0
914,ship++,config2,0.56516,100000002,176941144,134607,35782,98825,14825,4243,10582,1239,334,905,79460,9733,69727,39083,21472,17611
915,ship++,config2,0.915536,100000002,109225596,1373536,1062435,311101,396214,349668,46546,104382,43821,60561,675958,513485,162473,196982,155461,41521
916,ship++,config2,1.96954,100000000,50773152,865121,568545,296576,110526,92845,17681,417,406,11,655866,382476,273390,98312,92818,5494
917,ship++,config2,0.678674,100000003,147346064,2872436,74643,2797793,739080,101,738979,423298,7234,416064,1009340,1777,1007563,700718,65531,635187
918,ship++_shctr_5,config1,0.407352,100000000,245487953,1162156,361393,800763,632027,155720,476307,264148,77545,186603,0,0,0,265981,128128,137853
919,ship++_shctr_5,config1,0.723638,100000001,138190642,32513,7872,24641,21583,407,21176,3395,1,3394,0,0,0,7535,7464,71
920,ship++_shctr_5,config1,0.562508,100000001,177775182,5752317,1508759,4243558,806178,7,806171,2473064,411945,2061119,0,0,0,2473075,1096807,1376268
921,ship++_shctr_5,config1,0.40945,100000000,244230268,81693,61811,19882,53416,39658,13758,10648,4526,6122,0,0,0,17629,17627,2
922,ship++_shctr_5,config1,0.347559,100000003,287720543,4687866,808715,3879151,3310993,704105,2606888,20,0,20,0,0,0,1376853,104610,1272243
923,ship++_shctr_5,config1,1.13941,100000003,87764455,789891,120539,669352,401404,95099,306305,194181,905,193276,0,0,0,194306,24535,169771
924,ship++_shctr_5,config1,0.590382,100000000,169381931,5455667,1554901,3900766,763534,113,763421,2345912,471345,1874567,0,0,0,2346221,1083443,1262778
925,ship++_shctr_5,config1,0.286635,100000000,348875581,6993607,3870182,3123425,4167491,1831208,2336283,751805,302130,449675,0,0,0,2074311,1736844,337467
926,ship++_shctr_5,config1,0.917387,100000002,109005296,1399111,1073222,325889,1148254,827931,320323,122689,117755,4934,0,0,0,128168,127536,632
927,ship++_shctr_5,config1,0.751873,100000002,133001265,1449244,980208,469036,1202440,741349,461091,114012,108099,5913,0,0,0,132792,130760,2032
928,ship++_shctr_5,config1,0.0922318,100000002,1084224271,12167935,5934180,6233755,10389075,4733437,5655638,150276,90194,60082,0,0,0,1628584,1110549,518035
929,ship++_shctr_5,config1,1.08291,100000002,92343356,613111,286684,326427,304677,113382,191295,151947,75550,76397,0,0,0,156487,97752,58735
930,ship++_shctr_5,config1,0.234537,100000000,426371558,3244329,1278472,1965857,1933247,501209,1432038,328092,97256,230836,0,0,0,982990,680007,302983
931,ship++_shctr_5,config1,0.463877,100000000,215574413,4478635,1140652,3337983,2621558,717339,1904219,760153,99388,660765,0,0,0,1096924,323925,772999
932,ship++_shctr_5,config1,0.369751,100000001,270452138,4564556,1036813,3527743,3073735,653628,2420107,126461,111176,15285,0,0,0,1364360,272009,1092351
933,ship++_shctr_5,config1,0.444999,100000001,224719425,4917103,206635,4710468,3390381,129635,3260746,24,24,0,0,0,0,1526698,76976,1449722
934,ship++_shctr_5,config1,0.347156,100000003,288054710,4047234,257381,3789853,3006773,159726,2847047,24,18,6,0,0,0,1040437,97637,942800
935,ship++_shctr_5,config1,0.369044,100000001,270970185,2613321,2339103,274218,2495346,2241818,253528,37610,21746,15864,0,0,0,80365,75539,4826
936,ship++_shctr_5,config1,0.490939,100000000,203691256,373285,142116,231169,144395,55743,88652,71290,17015,54275,0,0,0,157600,69358,88242
937,ship++_shctr_5,config1,0.396682,100000001,252090942,2496547,1048893,1447654,2297414,850729,1446685,0,0,0,0,0,0,199133,198164,969
938,ship++_shctr_5,config1,0.450643,100000003,221904985,1769069,1293969,475100,1739414,1279381,460033,12908,2743,10165,0,0,0,16747,11845,4902
939,ship++_shctr_5,config1,0.543002,100000003,184161274,6027291,1583218,4444073,843448,145,843303,2591816,419564,2172252,0,0,0,2592027,1163509,1428518
940,ship++_shctr_5,config1,0.429795,100000003,232669127,1058894,131025,927869,632847,49426,583421,201034,793,200241,0,0,0,225013,80806,144207
941,ship++_shctr_5,config1,0.394417,100000000,253538579,411671,390017,21654,296216,280223,15993,32929,27660,5269,0,0,0,82526,82134,392
942,ship++_shctr_5,config1,0.733277,100000003,136374172,21200174,21146035,54139,194764,150667,44097,10471722,10461785,9937,0,0,0,10533688,10533583,105
943,ship++_shctr_5,config1,0.497303,100000000,201084501,3679349,1381762,2297587,2465984,872839,1593145,467647,175586,292061,0,0,0,745718,333337,412381
944,ship++_shctr_5,config1,0.830142,100000000,120461321,1432034,1204449,227585,1067508,938647,128861,180714,100738,79976,0,0,0,183812,165064,18748
945,ship++_shctr_5,config1,0.413338,100000003,241932508,1165598,353348,812250,633144,148923,484221,265372,75886,189486,0,0,0,267082,128539,138543
946,ship++_shctr_5,config1,0.381474,100000001,262141130,3801525,111615,3689910,2789401,95672,2693729,20,20,0,0,0,0,1012104,15923,996181
947,ship++_shctr_5,config1,0.425859,100000003,234819303,1105151,336661,768490,614443,156099,458344,245232,68243,176989,0,0,0,245476,112319,133157
948,ship++_shctr_5,config1,0.395925,100000003,252572980,405088,381637,23451,285450,267694,17756,34068,28825,5243,0,0,0,85570,85118,452
949,ship++_shctr_5,config1,0.433609,100000003,230622283,2675520,63279,2612241,1680645,8754,1671891,136848,10729,126119,0,0,0,858027,43796,814231
950,ship++_shctr_5,config1,0.502962,100000002,198822173,3572666,845208,2727458,2180513,505063,1675450,629126,125747,503379,0,0,0,763027,214398,548629
951,ship++_shctr_5,config1,0.234902,100000001,425709628,1984362,257416,1726946,1160902,100854,1060048,340264,31875,308389,0,0,0,483196,124687,358509
952,ship++_shctr_5,config1,0.614297,100000000,162787691,1575105,851918,723187,1332841,662154,670687,103774,74782,28992,0,0,0,138490,114982,23508
953,ship++_shctr_5,config1,0.12896,100000001,775435692,6966716,2705822,4260894,2413974,510015,1903959,1812774,721083,1091691,0,0,0,2739968,1474724,1265244
954,ship++_shctr_5,config1,0.746953,100000003,133877145,1134863,1001820,133043,519851,460953,58898,292434,223602,68832,0,0,0,322578,317265,5313
955,ship++_shctr_5,config1,0.115148,100000001,868447849,11193210,5072779,6120431,8987763,3631514,5356249,195620,123679,71941,0,0,0,2009827,1317586,692241
956,ship++_shctr_5,config1,1.02679,100000001,97391194,381989,15959,366030,315489,5936,309553,3447,1,3446,0,0,0,63053,10022,53031
957,ship++_shctr_5,config1,0.282953,100000003,353415647,7007033,3671892,3335141,4052519,1710476,2342043,856740,324914,531826,0,0,0,2097774,1636502,461272
958,ship++_shctr_5,config1,1.46561,100000003,68230786,1133161,1040582,92579,790337,733380,56957,47630,18022,29608,0,0,0,295194,289180,6014
959,ship++_shctr_5,config1,0.439855,100000003,227347387,2838711,65423,2773288,1956031,11744,1944287,140009,0,140009,0,0,0,742671,53679,688992
960,ship++_shctr_5,config1,0.316465,100000000,315990498,2825480,2582140,243340,2094626,1859479,235147,16394,16027,367,0,0,0,714460,706634,7826
961,ship++_shctr_5,config1,0.0842811,100000000,1186506260,14619483,7791883,6827600,14276877,7551471,6725406,25872,16556,9316,0,0,0,316734,223856,92878
962,ship++_shctr_5,config1,0.598158,100000000,167179908,1490750,473269,1017481,835381,196440,638941,219225,34041,185184,0,0,0,436144,242788,193356
963,ship++_shctr_5,config1,0.322603,100000002,309978644,5290141,2792674,2497467,3127300,1385212,1742088,652043,261029,391014,0,0,0,1510798,1146433,364365
964,ship++_shctr_5,config1,2.07426,100000001,48209981,1896,9,1887,1706,0,1706,181,0,181,0,0,0,9,9,0
965,ship++_shctr_5,config1,0.553272,100000000,180743000,119555,22851,96704,80540,2977,77563,1075,170,905,0,0,0,37940,19704,18236
966,ship++_shctr_5,config1,0.81631,100000002,122502455,991022,713621,277401,696690,507429,189261,102176,41816,60360,0,0,0,192156,164376,27780
967,ship++_shctr_5,config1,1.47046,100000003,68005861,827374,620744,206630,730855,524774,206081,414,393,21,0,0,0,96105,95577,528
968,ship++_shctr_5,config1,0.51624,100000003,193708294,2445955,76091,2369864,1321299,2008,1319291,423300,6189,417111,0,0,0,701356,67894,633462
969,ship++_shctr_5,config2,0.459678,100000000,217543569,1164075,328654,835421,21802,2200,19602,264086,76632,187454,612081,134426,477655,266106,115396,150710
970,ship++_shctr_5,config2,0.725208,100000001,137891538,42522,7078,35444,13577,394,13183,3352,12,3340,17694,474,17220,7899,6198,1701
971,ship++_shctr_5,config2,0.642845,100000001,155558602,5795879,1515957,4279922,417683,18870,398813,2473104,381156,2091948,431966,24516,407450,2473126,1091415,1381711
972,ship++_shctr_5,config2,0.410569,100000000,243564378,157868,133925,23943,71023,61828,9195,11273,5616,5657,50719,41858,8861,24853,24623,230
973,ship++_shctr_5,config2,0.606239,100000003,164951537,5145110,264503,4880607,521179,121901,399278,18,0,18,3246610,60899,3185711,1377303,81703,1295600
974,ship++_shctr_5,config2,1.42127,100000003,70359393,831761,68220,763541,26309,11959,14350,201327,7917,193410,401323,15008,386315,202802,33336,169466
975,ship++_shctr_5,config2,0.67461,100000000,148233677,5494503,1429874,4064629,392114,17046,375068,2345801,399087,1946714,410465,21948,388517,2346123,991793,1354330
976,ship++_shctr_5,config2,0.379625,100000000,263418073,8712581,4828820,3883761,2236155,1104747,1131408,764923,277079,487844,3551054,1640334,1910720,2160449,1806660,353789
977,ship++_shctr_5,config2,1.22265,100000003,81789851,1445926,835613,610313,118894,100108,18786,121986,120612,1374,1076650,486764,589886,128396,128129,267
978,ship++_shctr_5,config2,1.04518,100000000,95677399,1574043,823431,750612,202258,167829,34429,111347,109742,1605,1127282,414468,712814,133156,131392,1764
979,ship++_shctr_5,config2,0.109193,100000002,915812960,21078684,9683525,11395159,9506002,5872191,3633811,164362,54136,110226,9645416,2299399,7346017,1762904,1457799,305105
980,ship++_shctr_5,config2,1.3549,100000002,73806121,631986,286373,345613,36954,21071,15883,152073,75873,76200,287148,91015,196133,155811,98414,57397
981,ship++_shctr_5,config2,0.254708,100000000,392606558,4309283,1370903,2938380,1522721,446257,1076464,250497,92752,157745,1530023,183440,1346583,1006042,648454,357588
982,ship++_shctr_5,config2,0.638684,100000000,156571856,4600360,1085773,3514587,465838,131507,334331,742987,96678,646309,2291109,511142,1779967,1100426,346446,753980
983,ship++_shctr_5,config2,0.608872,100000001,164238002,4812824,563959,4248865,461857,41173,420684,126472,117188,9284,2860206,127870,2732336,1364289,277728,1086561
984,ship++_shctr_5,config2,0.556943,100000001,179551654,4917138,274971,4642167,1164424,60670,1103754,24,24,0,2225989,91893,2134096,1526701,122384,1404317
985,ship++_shctr_5,config2,0.483419,100000001,206859682,4047262,231086,3816176,834835,36746,798089,24,12,12,2171967,98159,2073808,1040436,96169,944267
986,ship++_shctr_5,config2,0.374667,100000001,266903396,4665251,2406786,2258465,2183910,2033045,150865,24955,12217,12738,2376017,297966,2078051,80369,63558,16811
987,ship++_shctr_5,config2,0.499381,100000001,200248056,479226,213233,265993,108310,58569,49741,72099,11019,61080,138957,58312,80645,159860,85333,74527
988,ship++_shctr_5,config2,0.446034,100000000,224197959,13009011,10699591,2309420,5289037,4386086,902951,0,0,0,6806735,5403889,1402846,913239,909616,3623
989,ship++_shctr_5,config2,0.462425,100000003,216251288,3282878,1545276,1737602,1562381,1353554,208827,5220,2724,2496,1698429,180363,1518066,16848,8635,8213
990,ship++_shctr_5,config2,0.63499,100000003,157482887,6065609,1641190,4424419,444250,17290,426960,2591716,476800,2114916,437707,21243,416464,2591936,1125857,1466079
991,ship++_shctr_5,config2,0.682256,100000000,146572571,1088811,146735,942076,57708,8711,48997,201523,1446,200077,601096,47321,553775,228484,89257,139227
992,ship++_shctr_5,config2,0.39753,100000000,251553635,656696,613020,43676,310904,302772,8132,30806,26543,4263,212706,182079,30627,102280,101626,654
993,ship++_shctr_5,config2,0.742133,100000003,134746811,21346125,21272488,73637,165898,131122,34776,10463422,10457724,5698,183317,150332,32985,10533488,10533310,178
994,ship++_shctr_5,config2,0.709624,100000000,140919746,3756962,1215137,2541825,404498,124249,280249,463754,173981,289773,2139528,580645,1558883,749182,336262,412920
995,ship++_shctr_5,config2,0.89616,100000000,111587181,2346652,2097097,249555,882518,862683,19835,180753,106153,74600,1098514,961944,136570,184867,166317,18550
996,ship++_shctr_5,config2,0.469835,100000003,212840460,1168747,334441,834306,25194,2508,22686,265309,76626,188683,610899,139031,471868,267345,116276,151069
997,ship++_shctr_5,config2,0.519938,100000000,192330767,3801551,129699,3671852,656032,36652,619380,20,20,0,2133394,77093,2056301,1012105,15934,996171
998,ship++_shctr_5,config2,0.484479,100000003,206407371,1107662,335675,771987,23260,3634,19626,245174,65624,179550,593719,163054,430665,245509,103363,142146
999,ship++_shctr_5,config2,0.399055,100000003,250591761,635538,579554,55984,295067,284696,10371,30364,25500,4864,206825,167844,38981,103282,101514,1768
1000,ship++_shctr_5,config2,0.580286,100000003,172328889,3300884,85178,3215706,970637,247,970390,136847,15324,121523,1335311,10425,1324886,858089,59182,798907
1001,ship++_shctr_5,config2,0.729923,100000001,137000676,3583001,750725,2832276,297327,64859,232468,622472,116457,506015,1899800,331739,1568061,763402,237670,525732
1002,ship++_shctr_5,config2,0.263306,100000001,379786179,2541222,351460,2189762,647303,65141,582162,278022,34186,243836,1132275,85490,1046785,483622,166643,316979
1003,ship++_shctr_5,config2,0.886362,100000000,112820658,1795750,753922,1041828,315582,201976,113606,99614,75890,23724,1239133,348990,890143,141421,127066,14355
1004,ship++_shctr_5,config2,0.138123,100000001,723993101,8752719,2579446,6173273,1888525,487589,1400936,1828635,412611,1416024,2272752,187382,2085370,2762807,1491864,1270943
1005,ship++_shctr_5,config2,0.769987,100000003,129872323,1571446,1425308,146138,429713,406909,22804,294159,233057,61102,521604,467259,54345,325970,318083,7887
1006,ship++_shctr_5,config2,0.121151,100000001,825416866,18753622,8204819,10548803,8469127,4416602,4052525,206406,70471,135935,7970618,2083462,5887156,2107471,1634284,473187
1007,ship++_shctr_5,config2,1.29397,100000001,77281723,382567,18343,364224,27952,435,27517,3434,3,3431,287945,4522,283423,63236,13383,49853
1008,ship++_shctr_5,config2,0.365537,100000003,273569971,8730015,4619947,4110068,2229838,1050584,1179254,871511,338610,532901,3453734,1510401,1943333,2174932,1720352,454580
1009,ship++_shctr_5,config2,1.80032,100000000,55545827,1161476,1023710,137766,133692,126596,7096,47550,19967,27583,680414,578921,101493,299820,298226,1594
1010,ship++_shctr_5,config2,0.557498,100000003,179372842,3481389,61679,3419710,1002050,47,1002003,140009,0,140009,1596659,9770,1586889,742671,51862,690809
1011,ship++_shctr_5,config2,0.339603,100000000,294461502,5227555,4920249,307306,2121356,1999113,122243,29853,29571,282,2267177,2092958,174219,809169,798607,10562
1012,ship++_shctr_5,config2,0.122361,100000000,817252330,26955615,13331209,13624406,11716642,9771002,1945640,27355,10887,16468,14877906,3294734,11583172,333712,254586,79126
1013,ship++_shctr_5,config2,0.78112,100000000,128021332,1495369,459075,1036294,89096,23935,65161,219210,38553,180657,750913,154380,596533,436150,242207,193943
1014,ship++_shctr_5,config2,0.403897,100000003,247588142,6596404,3295756,3300648,1693817,767828,925989,658476,257221,401255,2683485,1096709,1586776,1560626,1173998,386628
1015,ship++_shctr_5,config2,2.07905,100000001,48098913,2155,25,2130,803,0,803,129,0,129,1200,2,1198,23,23,0
1016,ship++_shctr_5,config2,0.565152,100000002,176943513,134635,35743,98892,14827,4244,10583,1240,335,905,79484,9734,69750,39084,21430,17654
1017,ship++_shctr_5,config2,0.915038,100000002,109285025,1373538,1059264,314274,396211,349507,46704,104383,39845,64538,675963,510490,165473,196981,159422,37559
1018,ship++_shctr_5,config2,1.9946,100000000,50135466,865120,640211,224909,110525,92393,18132,417,412,5,655866,454423,201443,98312,92983,5329
1019,ship++_shctr_5,config2,0.678674,100000003,147346064,2872436,74643,2797793,739080,101,738979,423298,7234,416064,1009340,1777,1007563,700718,65531,635187
1020,ship++_leaders_16,config1,0.414618,100000000,241186139,1162156,367501,794655,632027,188919,443108,264148,48477,215671,0,0,0,265981,130105,135876
1021,ship++_leaders_16,config1,0.723636,100000001,138191059,32513,7897,24616,21583,407,21176,3395,1,3394,0,0,0,7535,7489,46
1022,ship++_leaders_16,config1,0.552087,100000001,181130929,5752308,1406746,4345562,806178,70,806108,2473061,343115,2129946,0,0,0,2473069,1063561,1409508
1023,ship++_leaders_16,config1,0.40945,100000000,244230268,81693,61813,19880,53416,39658,13758,10648,4526,6122,0,0,0,17629,17629,0
1024,ship++_leaders_16,config1,0.347608,100000003,287680466,4687860,814037,3873823,3310987,705319,2605668,20,0,20,0,0,0,1376853,108718,1268135
1025,ship++_leaders_16,config1,1.13929,100000003,87774283,789891,122363,667528,401404,95285,306119,194181,913,193268,0,0,0,194306,26165,168141
1026,ship++_leaders_16,config1,0.5866,100000000,170473983,5455664,1460904,3994760,763532,124,763408,2345911,435235,1910676,0,0,0,2346221,1025545,1320676
1027,ship++_leaders_16,config1,0.287797,100000000,347466759,6993617,3933379,3060238,4167498,1849748,2317750,751795,311632,440163,0,0,0,2074324,1771999,302325
1028,ship++_leaders_16,config1,0.925778,100000002,108017311,1399115,1093266,305849,1148258,853064,295194,122689,114046,8643,0,0,0,128168,126156,2012
1029,ship++_leaders_16,config1,0.742865,100000002,134613979,1449246,953042,496204,1202440,711687,490753,114014,110012,4002,0,0,0,132792,131343,1449
1030,ship++_leaders_16,config1,0.0925525,100000002,1080468027,12168020,5952087,6215933,10389127,4757717,5631410,150299,86655,63644,0,0,0,1628594,1107715,520879
1031,ship++_leaders_16,config1,1.08343,100000002,92299302,613107,291112,321995,304677,113694,190983,151946,75721,76225,0,0,0,156484,101697,54787
1032,ship++_leaders_16,config1,0.235071,100000000,425402899,3244354,1195074,2049280,1932714,491891,1440823,328626,92034,236592,0,0,0,983014,611149,371865
1033,ship++_leaders_16,config1,0.463923,100000000,215553173,4478621,1185120,3293501,2621644,728396,1893248,760083,99456,660627,0,0,0,1096894,357268,739626
1034,ship++_leaders_16,config1,0.368006,100000001,271734840,4564558,1057572,3506986,3073736,644233,2429503,126461,115386,11075,0,0,0,1364361,297953,1066408
1035,ship++_leaders_16,config1,0.446176,100000001,224126703,4917103,281870,4635233,3390381,161529,3228852,24,8,16,0,0,0,1526698,120333,1406365
1036,ship++_leaders_16,config1,0.342247,100000003,292186926,4047234,196401,3850833,3006773,80285,2926488,24,11,13,0,0,0,1040437,116105,924332
1037,ship++_leaders_16,config1,0.36795,100000001,271776044,2613320,2314656,298664,2495336,2217630,277706,37619,21693,15926,0,0,0,80365,75333,5032
1038,ship++_leaders_16,config1,0.491053,100000000,203644177,373284,142700,230584,144394,56306,88088,71290,14089,57201,0,0,0,157600,72305,85295
1039,ship++_leaders_16,config1,0.397856,100000001,251347334,2500080,1060378,1439702,2300002,860693,1439309,0,0,0,0,0,0,200078,199685,393
1040,ship++_leaders_16,config1,0.458484,100000003,218110103,1769069,1469899,299170,1739414,1456352,283062,12908,2651,10257,0,0,0,16747,10896,5851
1041,ship++_leaders_16,config1,0.545463,100000003,183330594,6027293,1574987,4452306,843449,152,843297,2591819,442632,2149187,0,0,0,2592025,1132203,1459822
1042,ship++_leaders_16,config1,0.429461,100000003,232850216,1058894,135722,923172,632847,47452,585395,201034,794,200240,0,0,0,225013,87476,137537
1043,ship++_leaders_16,config1,0.394456,100000000,253513875,411671,390288,21383,296216,280457,15759,32929,27662,5267,0,0,0,82526,82169,357
1044,ship++_leaders_16,config1,0.733313,100000003,136367367,21200174,21146033,54141,194764,150658,44106,10471722,10461785,9937,0,0,0,10533688,10533590,98
1045,ship++_leaders_16,config1,0.493099,100000000,202799094,3679353,1358081,2321272,2465989,843152,1622837,467647,176865,290782,0,0,0,745717,338064,407653
1046,ship++_leaders_16,config1,0.828191,100000000,120745063,1432055,1212049,220006,1067512,937365,130147,180724,103843,76881,0,0,0,183819,170841,12978
1047,ship++_leaders_16,config1,0.419003,100000003,238662009,1165597,363852,801745,633144,168072,465072,265372,69238,196134,0,0,0,267081,126542,140539
1048,ship++_leaders_16,config1,0.381658,100000001,262014906,3801525,115587,3685938,2789401,99644,2689757,20,20,0,0,0,0,1012104,15923,996181
1049,ship++_leaders_16,config1,0.432038,100000003,231461220,1105151,361869,743282,614443,179998,434445,245232,67174,178058,0,0,0,245476,114697,130779
1050,ship++_leaders_16,config1,0.395835,100000003,252630738,405078,381464,23614,285435,267274,18161,34070,28926,5144,0,0,0,85573,85264,309
1051,ship++_leaders_16,config1,0.433467,100000003,230697991,2675520,654544,2020976,1680645,11301,1669344,136848,6152,130696,0,0,0,858027,637091,220936
1052,ship++_leaders_16,config1,0.503686,100000002,198536514,3572673,885656,2687017,2180517,527477,1653040,629129,119853,509276,0,0,0,763027,238326,524701
1053,ship++_leaders_16,config1,0.23753,100000001,420999179,1985055,275841,1709214,1160755,133347,1027408,340410,39010,301400,0,0,0,483890,103484,380406
1054,ship++_leaders_16,config1,0.614754,100000000,162666771,1575100,847061,728039,1332837,660804,672033,103774,75377,28397,0,0,0,138489,110880,27609
1055,ship++_leaders_16,config1,0.126682,100000001,789375132,6966700,2718534,4248166,2413964,442771,1971193,1812771,572535,1240236,0,0,0,2739965,1703228,1036737
1056,ship++_leaders_16,config1,0.746661,100000003,133929644,1134874,1002031,132843,519857,460211,59646,292435,223814,68621,0,0,0,322582,318006,4576
1057,ship++_leaders_16,config1,0.116165,100000001,860846291,11193224,5170433,6022791,8987775,3700140,5287635,195591,127539,68052,0,0,0,2009858,1342754,667104
1058,ship++_leaders_16,config1,1.02574,100000001,97491002,381988,14525,367463,315488,5106,310382,3447,1,3446,0,0,0,63053,9418,53635
1059,ship++_leaders_16,config1,0.28333,100000003,352945115,7007019,3796532,3210487,4052504,1737201,2315303,856738,318328,538410,0,0,0,2097777,1741003,356774
1060,ship++_leaders_16,config1,1.45172,100000003,68883882,1133161,1044342,88819,790337,729596,60741,47630,19981,27649,0,0,0,295194,294765,429
1061,ship++_leaders_16,config1,0.439291,100000003,227639458,2838711,305935,2532776,1956031,10940,1945091,140009,0,140009,0,0,0,742671,294995,447676
1062,ship++_leaders_16,config1,0.316407,100000000,316048487,2825481,2583819,241662,2094627,1859332,235295,16394,16032,362,0,0,0,714460,708455,6005
1063,ship++_leaders_16,config1,0.0843192,100000000,1185970070,14619441,7788997,6830444,14276843,7553646,6723197,25871,16442,9429,0,0,0,316727,218909,97818
1064,ship++_leaders_16,config1,0.595196,100000000,168011885,1490754,480586,1010168,835383,189785,645598,219224,28464,190760,0,0,0,436147,262337,173810
1065,ship++_leaders_16,config1,0.322668,100000003,309916098,5290120,2825940,2464180,3127283,1410457,1716826,652047,267580,384467,0,0,0,1510790,1147903,362887
1066,ship++_leaders_16,config1,2.07426,100000001,48209981,1896,9,1887,1706,0,1706,181,0,181,0,0,0,9,9,0
1067,ship++_leaders_16,config1,0.553207,100000000,180764299,119557,26239,93318,80541,3118,77423,1075,170,905,0,0,0,37941,22951,14990
1068,ship++_leaders_16,config1,0.811156,100000002,123280908,991019,712815,278204,696687,500567,196120,102176,38523,63653,0,0,0,192156,173725,18431
1069,ship++_leaders_16,config1,1.50761,100000003,66330301,827373,657155,170218,730854,561138,169716,414,393,21,0,0,0,96105,95624,481
1070,ship++_leaders_16,config1,0.515597,100000003,193949909,2445955,87930,2358025,1321299,1344,1319955,423300,3956,419344,0,0,0,701356,82630,618726
1071,ship++_leaders_16,config2,0.459518,100000000,217619292,1164700,342878,821822,22650,2310,20340,264086,58629,205457,611855,161543,450312,266109,120396,145713
1072,ship++_leaders_16,config2,0.725276,100000001,137878557,42522,8625,33897,13577,399,13178,3352,12,3340,17694,482,17212,7899,7732,167
1073,ship++_leaders_16,config2,0.635962,100000001,157242033,5796351,1424394,4371957,417815,18967,398848,2473091,328769,2144322,432333,24913,407420,2473112,1051745,1421367
1074,ship++_leaders_16,config2,0.410571,100000000,243563481,157868,133940,23928,71023,61830,9193,11273,5616,5657,50719,41866,8853,24853,24628,225
1075,ship++_leaders_16,config2,0.605885,100000003,165047797,5145119,267446,4877673,521475,123573,397902,17,0,17,3246331,51380,3194951,1377296,92493,1284803
1076,ship++_leaders_16,config2,1.42424,100000003,70212666,831323,76145,755178,26220,12370,13850,201271,7809,193462,401092,21122,379970,202740,34844,167896
1077,ship++_leaders_16,config2,0.659447,100000000,151642224,5499306,1345604,4153702,395109,19338,375771,2345794,315042,2030752,412279,24531,387748,2346124,986693,1359431
1078,ship++_leaders_16,config2,0.378272,100000000,264360233,8717545,4772629,3944916,2238924,1087509,1151415,764936,297328,467608,3553133,1607311,1945822,2160552,1780481,380071
1079,ship++_leaders_16,config2,1.22888,100000003,81374976,1445908,859995,585913,118892,99573,19319,121989,120747,1242,1076633,511528,565105,128394,128147,247
1080,ship++_leaders_16,config2,1.02689,100000000,97381598,1574043,780068,793975,202412,161615,40797,111349,110080,1269,1127127,378047,749080,133155,130326,2829
1081,ship++_leaders_16,config2,0.108962,100000002,917751881,21078592,9689752,11388840,9506128,5810591,3695537,164314,52775,111539,9645233,2348758,7296475,1762917,1477628,285289
1082,ship++_leaders_16,config2,1.35955,100000002,73553977,631980,295304,336676,37168,23772,13396,152071,75900,76171,286932,95112,191820,155809,100520,55289
1083,ship++_leaders_16,config2,0.254415,100000000,393059312,4309262,1318387,2990875,1522623,435873,1086750,250366,86572,163794,1530239,184111,1346128,1006034,611831,394203
1084,ship++_leaders_16,config2,0.638812,100000000,156540565,4600292,1112052,3488240,465453,129233,336220,742827,94244,648583,2291944,502945,1788999,1100068,385630,714438
1085,ship++_leaders_16,config2,0.606681,100000001,164831289,4812941,575172,4237769,462159,34092,428067,126472,117272,9200,2860022,131532,2728490,1364288,292276,1072012
1086,ship++_leaders_16,config2,0.554872,100000003,180221722,4917133,277344,4639789,1163822,45329,1118493,24,19,5,2226589,99193,2127396,1526698,132803,1393895
1087,ship++_leaders_16,config2,0.482961,100000001,207056082,4047262,222650,3824612,834420,28149,806271,24,15,9,2172382,83853,2088529,1040436,110633,929803
1088,ship++_leaders_16,config2,0.373241,100000001,267923080,4665134,2362680,2302454,2182506,1998513,183993,24959,12030,12929,2377300,291893,2085407,80369,60244,20125
1089,ship++_leaders_16,config2,0.499466,100000001,200213679,479229,234687,244542,108314,59346,48968,72099,16502,55597,138953,60686,78267,159863,98153,61710
1090,ship++_leaders_16,config2,0.445582,100000000,224425632,13009442,10685977,2323465,5289551,4384273,905278,0,0,0,6806891,5392015,1414876,913000,909689,3311
1091,ship++_leaders_16,config2,0.462609,100000003,216165489,3282988,1509492,1773496,1561967,1391143,170824,5220,2718,2502,1698953,107404,1591549,16848,8227,8621
1092,ship++_leaders_16,config2,0.624537,100000003,160118727,6073271,1511466,4561805,448032,20885,427147,2591732,404953,2186779,441540,25264,416276,2591967,1060364,1531603
1093,ship++_leaders_16,config2,0.682404,100000000,146540757,1089301,146667,942634,57696,9294,48402,201539,1484,200055,601523,44261,557262,228543,91628,136915
1094,ship++_leaders_16,config2,0.397374,100000000,251651961,656700,611406,45294,310899,302778,8121,30806,26433,4373,212715,180424,32291,102280,101771,509
1095,ship++_leaders_16,config2,0.742072,100000003,134757821,21346124,21272658,73466,165902,131106,34796,10463422,10457724,5698,183312,150509,32803,10533488,10533319,169
1096,ship++_leaders_16,config2,0.714105,100000000,140035521,3757290,1248537,2508753,405141,132918,272223,463760,174002,289758,2139185,595547,1543638,749204,346070,403134
1097,ship++_leaders_16,config2,0.897536,100000000,111416211,2346528,2093927,252601,882484,865169,17315,180695,104578,76117,1098540,962987,135553,184809,161193,23616
1098,ship++_leaders_16,config2,0.46966,100000003,212919893,1168970,336383,832587,25456,2252,23204,265309,73679,191630,610859,142193,468666,267346,118259,149087
1099,ship++_leaders_16,config2,0.519921,100000000,192336782,3801551,132371,3669180,655173,38585,616588,20,20,0,2134253,77690,2056563,1012105,16076,996029
1100,ship++_leaders_16,config2,0.483848,100000003,206676592,1108151,335253,772898,23804,2545,21259,245174,62113,183061,593663,166593,427070,245510,104002,141508
1101,ship++_leaders_16,config2,0.398734,100000003,250793682,635555,581491,54064,295078,283381,11697,30364,25992,4372,206831,169518,37313,103282,102600,682
1102,ship++_leaders_16,config2,0.579061,100000003,172693354,3300884,678574,2622310,970671,3,970668,136847,14657,122190,1335277,8562,1326715,858089,655352,202737
1103,ship++_leaders_16,config2,0.730787,100000001,136838849,3582821,778873,2803948,297518,65537,231981,622475,116993,505482,1899502,332837,1566665,763326,263506,499820
1104,ship++_leaders_16,config2,0.263415,100000001,379629055,2541130,359980,2181150,647436,69403,578033,277812,33055,244757,1132174,89429,1042745,483708,168093,315615
1105,ship++_leaders_16,config2,0.870039,100000000,114937383,1795684,771402,1024282,314595,140777,173818,99648,79736,19912,1240031,422215,817816,141410,128674,12736
1106,ship++_leaders_16,config2,0.138335,100000001,722881711,8754439,2698018,6056421,1890323,508251,1382072,1828616,315696,1512920,2272711,202346,2070365,2762789,1671725,1091064
1107,ship++_leaders_16,config2,0.769575,100000003,129941913,1571593,1429436,142157,429763,406401,23362,294162,232603,61559,521699,470343,51356,325969,320089,5880
1108,ship++_leaders_16,config2,0.120691,100000001,828561687,18755737,8221449,10534288,8469655,4351987,4117668,206452,68934,137518,7972087,2170318,5801769,2107543,1630210,477333
1109,ship++_leaders_16,config2,1.29372,100000001,77296307,382564,20510,362054,27905,286,27619,3435,3,3432,287990,2954,285036,63234,17267,45967
1110,ship++_leaders_16,config2,0.365326,100000003,273727842,8729245,4650661,4078584,2229754,1050598,1179156,871495,297721,573774,3453084,1513876,1939208,2174912,1788466,386446
1111,ship++_leaders_16,config2,1.78869,100000000,55906897,1161479,995383,166096,133712,122202,11510,47550,18354,29196,680397,557362,123035,299820,297465,2355
1112,ship++_leaders_16,config2,0.557416,100000003,179399242,3481393,294944,3186449,1002054,42,1002012,140009,0,140009,1596659,9471,1587188,742671,285431,457240
1113,ship++_leaders_16,config2,0.339566,100000000,294493420,5227614,4925347,302267,2121362,1998759,122603,29854,29578,276,2267228,2096155,171073,809170,800855,8315
1114,ship++_leaders_16,config2,0.123412,100000000,810292665,26950875,13352034,13598841,11714337,9849219,1865118,27325,10576,16749,14875530,3215899,11659631,333683,276340,57343
1115,ship++_leaders_16,config2,0.784207,100000000,127517269,1495344,511118,984226,90147,28080,62067,219210,33562,185648,749841,172388,577453,436146,277088,159058
1116,ship++_leaders_16,config2,0.405502,100000003,246607908,6595677,3319726,3275951,1694863,780253,914610,658482,236334,422148,2681685,1105667,1576018,1560647,1197472,363175
1117,ship++_leaders_16,config2,2.07905,100000001,48098913,2155,25,2130,803,0,803,129,0,129,1200,2,1198,23,23,0
1118,ship++_leaders_16,config2,0.56515,100000002,176944116,134593,38961,95632,14841,4235,10606,1230,327,903,79450,9803,69647,39072,24596,14476
1119,ship++_leaders_16,config2,0.913207,100000002,109504208,1373535,1062922,310613,396222,348554,47668,104382,38419,65963,675949,503663,172286,196982,172286,24696
1120,ship++_leaders_16,config2,1.97236,100000000,50700762,865125,542590,322535,110530,92665,17865,417,412,5,655866,363772,292094,98312,85741,12571
1121,ship++_leaders_16,config2,0.677888,100000003,147516966,2872436,86675,2785761,739092,49,739043,423298,5054,418244,1009328,1417,1007911,700718,80155,620563
